！恩=！嗯
！象=！像
「恩=「嗯
「恩！=「嗯！
「當=「當
「當！=「噹！
「當」=「噹」
○余=○餘
○海=○海
○海裡=○海里
○裡=○里
0寸=0吋
0天=0天
0天后=0天後
0余=0餘
０余=０餘
0海=0海
０海=０海
0海裡=0海里
０海裡=０海里
0裡=0里
０裡=０里
1寸=1吋
1天=1天
1天后=1天後
1海=1海
1海裡=1海里
1裡=1里
2寸=2吋
2天=2天
2天后=2天後
2海=2海
2海裡=2海里
2裡=2里
3寸=3吋
3天=3天
3天后=3天後
3海=3海
3海裡=3海里
3裡=3里
4寸=4吋
4天=4天
4天后=4天後
4海=4海
4海裡=4海里
4裡=4里
5寸=5吋
5天=5天
5天后=5天後
5海=5海
5海裡=5海里
5裡=5里
6寸=6吋
6天=6天
6天后=6天後
6海=6海
6海裡=6海里
6裡=6里
7寸=7吋
7天=7天
7天后=7天後
7海=7海
7海裡=7海里
7裡=7里
8寸=8吋
8天=8天
8天后=8天後
8海=8海
8海裡=8海里
8裡=8里
9寸=9吋
9天=9天
9天后=9天後
9海=9海
9海裡=9海里
9裡=9里
a』=a'
A』=A'
b』=b'
B』=B'
c』=c'
C』=C'
d』=d'
D』=D'
e』=e'
E』=E'
f』=f'
F』=F'
g』=g'
G』=G'
h』=h'
H』=H'
i』=i'
I』=I'
j』=j'
J』=J'
k』=k'
K』=K'
l』=l'
L』=L'
m』=m'
M』=M'
n』=n'
N』=N'
n天=n天
N天=N天
o』=o'
O』=O'
p』=p'
P』=P'
q』=q'
Q』=Q'
r』=r'
R』=R'
s』=s'
S』=S'
t』=t'
T』=T'
u』=u'
U』=U'
v』=v'
V』=V'
w』=w'
W』=W'
x』=x'
X』=X'
y』=y'
Y』=Y'
z』=z'
Z』=Z'
一大=一大
一大伙=一大夥
一干=一干
一干二淨=一乾二淨
一干而盡=一乾而盡
一干就=一幹就
一天=一天
一天后=一天後
一扎=一紮
一斗=一斗
一斗不=一鬥不
一斗再斗=一鬥再鬥
一出=一出
一出好戲=一齣好戲
一出京劇=一齣京劇
一出話劇=一齣話劇
一出電影=一齣電影
一出劇=一齣劇
一出劇院=一出劇院
一出戲=一齣戲
一只=一隻
一只只=一隻隻
一只只有=一隻只有
一只只夠=一隻只夠
一伙=一夥
一并=一併
一沖=一沖
一沖一撞=一衝一撞
一並=一併
一並不=一並不
一並且=一並且
一並非=一並非
一制=一制
一制作=一製作
一制程=一製程
一制藥=一製藥
一周=一週
一松=一鬆
一松林=一松林
一松鼠=一松鼠
一松樹=一松樹
一物=一物
一物克一=一物剋一
一直=一直
一直干=一直幹
一直發女=一直髮女
一面=一面
一個=一個
一海=一海
一海裡=一海里
一涂=一塗
一般=一般
一般只=一般只
一毫=一毫
一毫一發=一毫一髮
一游=一遊
一發=一發
一發千鈞=一髮千鈞
一發之差=一髮之差
一發之間=一髮之間
一裡=一里
一裡余=一里餘
一箭=一箭
一箭雙雕=一箭雙鵰
一樹=一樹
一樹百獲=一樹百穫
一鍋=一鍋
一鍋面=一鍋麵
一點=一點
一點丑=一點醜
一贊=一讚
乙丑=乙丑
丁丑=丁丑
丁当=叮噹
丁铃=叮鈴
丁當=叮噹
丁鈴=叮鈴
七天=七天
七天后=七天後
七只=七隻
七面=七面
七海=七海
七海裡=七海里
七海裡面=七海裡面
七裡=七里
七裡余=七里餘
九天=九天
九天后=九天後
九只=九隻
九叹=九歎
九面=九面
九海=九海
九海裡=九海里
九裡=九里
九裡余=九里餘
九嘆=九歎
了如=了如
了如指掌=瞭如指掌
了若=了若
了若指掌=瞭若指掌
了准=了准
了准有=了準有
了准的=了準的
了准時=了準時
了准備=了準備
了准確=了準確
了望=瞭望
了然=瞭然
了然於胸=了然於胸
了解=瞭解
二天=二天
二天后=二天後
二手=二手
二手煙=二手菸
二只=二隻
二面=二面
二個=二個
二海=二海
二海裡=二海里
二裡=二里
二撇=二撇
二撇胡=二撇鬍
人干=人幹
人丑=人醜
人物=人物
人物志=人物誌
人欲=人欲
人欲橫流=人慾橫流
人游=人遊
人象=人像
人雲=人云
人雲亦雲=人云亦云
人雲游=人云遊
人雲集=人雲集
人像征=人象徵
人贊=人讚
入伙=入夥
八天=八天
八天后=八天後
八只=八隻
八字=八字
八字胡=八字鬍
八周=八週
八海=八海
八海裡=八海里
八裡=八里
八裡余=八里餘
几天=幾天
几出=幾齣
几只=幾隻
几里=幾里
几净=几淨
几周=幾週
刀削=刀削
刀削面=刀削麵
力干=力幹
力干政=力干政
力干涉=力干涉
力干預=力干預
力干擾=力干擾
力斗=力鬥
力拼=力拚
十分=十分
十分干=十分乾
十分丑=十分醜
十分的准=十分的準
十分准=十分準
十天=十天
十只=十隻
十余=十餘
十余只=十餘隻
十余裡=十餘里
十卷=十捲
十周=十週
十面=十面
十海=十海
十海裡=十海里
十裡=十里
十裡余=十里餘
又干=又幹
又干又=又乾又
又干又硬=又乾又硬
又干政=又干政
又干涉=又干涉
又干淨=又乾淨
又干預=又干預
又干擾=又干擾
又丑=又醜
又斗=又鬥
又沖=又沖
又沖上=又衝上
又沖下=又衝下
又沖回=又衝回
又沖掉=又衝掉
又松=又鬆
又咸=又鹹
又象=又像
又雲=又云
万历=萬曆
万只=萬隻
万余=萬餘
万里=萬里
丈余=丈餘
三天=三天
三扎=三紮
三只=三隻
三叹=三歎
三周=三週
三個=三個
三海=三海
三海裡=三海里
三國=三國
三國志=三國志
三裡=三里
三裡余=三里餘
三嘆=三歎
三豐=三丰
上布=上佈
上冲=上衝
上折=上摺
上沖=上衝
上沖水=上沖水
上沖刷=上沖刷
上沖洗=上沖洗
上沖涼=上沖涼
上沖澡=上沖澡
上周=上週
上准=上準
上梁=上樑
上梁山=上梁山
上签=上籤
上簽=上籤
下台=下台
下冲=下衝
下沖=下衝
下咽=下嚥
下梁=下樑
下摆=下襬
下签=下籤
下裡=下里
下擺=下襬
下簽=下籤
个象=個像
久斗=久鬥
么儿=么兒
么干=麼幹
么象=麼像
也沒=也沒
也沒干=也沒幹
也舍=也舍
也舍下=也捨下
也舍棄=也捨棄
也象=也像
乡里=鄉里
乡愿=鄉愿
于归=于歸
于谦=于謙
于阗=于闐
亿余=億餘
兀术=兀朮
兀術=兀朮
千天=千天
千扎=千紮
千只=千隻
千余=千餘
千余只=千餘隻
千余裡=千餘里
千海=千海
千海裡=千海里
千鈞=千鈞
千鈞一發=千鈞一髮
千裡=千里
千層=千層
千層面=千層麵
千鎚=千錘
口干=口乾
口干一=口幹一
口干什=口幹什
口干那=口幹那
口干活=口幹活
口干員=口幹員
口干掉=口幹掉
口干這=口幹這
口干著=口幹著
口佔=口占
土制=土製
土剉=土銼
大小=大小
大小只=大小只
大干=大干
大干特干=大幹特幹
大丑=大醜
大历=大曆
大斗=大鬥
大只=大隻
大伙=大夥
大伙人=大夥人
大伙兒=大夥兒
大利=大利
大利面=大利麵
大国=大國
大潤=大潤
大潤發=大潤發
大衝=大沖
大衝擊=大衝擊
大歷=大曆
大歷史=大歷史
大贊=大讚
子姜=子薑
子雲=子云
子鍾=子鐘
寸余=寸餘
小丑=小丑
小丑丫鬟=小醜丫鬟
小伙=小夥
尸禄=尸祿
山羊=山羊
山羊胡=山羊鬍
山羊須=山羊鬚
山岳=山嶽
山涯=山崖
工余=工餘
己干=己幹
己丑=己丑
已余=已餘
已松=已鬆
已松下=已鬆下
已象=已像
已象征服=已像征服
已象征戰=已像征戰
已愈=已癒
已經=已經
已經斗=已經鬥
已經象=已經像
干！=幹！
干一=幹一
干一杯=乾一杯
干一碗=乾一碗
干一壇=乾一罈
干一壇法=幹一壇法
干了=幹了
干儿=乾兒
干又=干又
干又熱=乾又熱
干上=幹上
干下=干下
干下去=幹下去
干个=幹個
干么=幹麼
干土=乾土
干大=干大
干大事=幹大事
干女=干女
干女友=幹女友
干女同事=幹女同事
干女兒=乾女兒
干女教師=幹女教師
干女婿=乾女婿
干尸=乾屍
干干=乾乾
干干巴巴=乾乾巴巴
干干的=乾乾的
干干脆脆=乾乾脆脆
干干淨淨=乾乾淨淨
干干爽爽=乾乾爽爽
干干瘦瘦=乾乾瘦瘦
干弋=干戈
干才=幹才
干不=幹不
干不下=幹不下
干不干=幹不幹
干不干杯=乾不乾杯
干不干淨=乾不乾淨
干井=乾井
干什=幹什
干办=幹辦
干化=乾化
干巴=乾巴
干巴巴=乾巴巴
干手=干手
干手淨腳=乾手淨腳
干毛=干毛
干毛巾=乾毛巾
干丝=乾絲
干他=幹他
干出=幹出
干发=乾髮
干叶=乾葉
干号=乾號
干布=乾布
干打=干打
干打雷=乾打雷
干正=干正
干正事=幹正事
干犯=干犯
干犯法=幹犯法
干生=干生
干生氣=乾生氣
干件=幹件
干任=干任
干任何=幹任何
干份=幹份
干冰=乾冰
干吏=幹吏
干吗=幹嗎
干她=幹她
干好=幹好
干妈=乾媽
干孙=乾孫
干尽=幹盡
干式=乾式
干成=幹成
干此=幹此
干此杯=乾此杯
干此壇=乾此罈
干江=灨江
干肉=乾肉
干肉販=幹肉販
干衣=乾衣
干伸=干伸
干伸舌=乾伸舌
干似=乾似
干何=干何
干何事=幹何事
干你=幹你
干你娘=幹你娘
干冷=乾冷
干別=干別
干別的=幹別的
干劲=幹勁
干呕=乾嘔
干员=幹員
干坐=干坐
干坐著=乾坐著
干坛=乾罈
干声=乾聲
干完=幹完
干弟=乾弟
干我=幹我
干旱=乾旱
干材=幹材
干沙=乾沙
干系=干係
干过=幹過
干那=幹那
干那一杯=乾那一杯
干那杯=乾那杯
干阳=乾陽
干饭=乾飯
干事=幹事
干些=幹些
干兒=乾兒
干兩=干兩
干兩年=幹兩年
干兩杯=乾兩杯
干净=乾淨
干到=幹到
干坤=乾坤
干妹=乾妹
干姊=乾姊
干姐=乾姐
干季=乾季
干底=乾底
干性=乾性
干杯=乾杯
干果=乾果
干枝=乾枝
干泥=乾泥
干爸=乾爸
干的=干的
干的好=幹的好
干线=幹線
干练=幹練
干股=乾股
干花=乾花
干货=乾貨
干这=幹這
干冒=干冒
干冒煙=乾冒煙
干勁=幹勁
干咳=乾咳
干咽=乾嚥
干品=乾品
干哑=乾啞
干姜=乾薑
干屍=乾屍
干枯=乾枯
干架=幹架
干洗=乾洗
干活=幹活
干流=幹流
干点=幹點
干甚=幹甚
干疤=乾疤
干结=乾結
干面=乾麵
干面前=乾面前
干個=幹個
干員=幹員
干哥=乾哥
干哪=幹哪
干哭=乾哭
干娘=乾娘
干孫=乾孫
干料=乾料
干晒=乾曬
干柴=乾柴
干校=幹校
干桩=幹樁
干涧=乾澗
干涩=乾澀
干烧=乾燒
干热=乾熱
干爹=乾爹
干站=干站
干站著=乾站著
干笑=乾笑
干粉=乾粉
干耗=乾耗
干脆=乾脆
干草=乾草
干起=幹起
干假=幹假
干啞=乾啞
干啥=幹啥
干強=干強
干強盜=幹強盜
干得=幹得
干得一杯=乾得一杯
干得三杯=乾得三杯
干得兩杯=乾得兩杯
干得很=乾得很
干惯=幹慣
干掉=幹掉
干掉一杯=乾掉一杯
干掉一瓶=乾掉一瓶
干掉一碗=乾掉一碗
干掉那杯=乾掉那杯
干掉那碗=乾掉那碗
干掉杯=乾掉杯
干掉這杯=乾掉這杯
干掉這碗=乾掉這碗
干探=幹探
干梅=乾梅
干涸=乾涸
干淨=乾淨
干清=干清
干清宮=乾清宮
干爽=乾爽
干球=幹球
干眼=乾眼
干着=幹著
干粗=干粗
干粗活=幹粗活
干細=干細
干細胞=幹細胞
干貨=乾貨
干貨物=幹貨物
干透=乾透
干這=幹這
干這一杯=乾這一杯
干這杯=乾這杯
干部=幹部
干就=干就
干就干=幹就幹
干幾=干幾
干幾手=乾幾手
干幾件=幹幾件
干幾宗=幹幾宗
干幾杯=乾幾杯
干幾番=幹幾番
干幾碗=乾幾碗
干幾樁=幹幾樁
干幾輩=幹幾輩
干搁=乾擱
干渴=乾渴
干湿=乾濕
干焦=乾焦
干發=乾髮
干硬=乾硬
干窘=乾窘
干等=乾等
干結=乾結
干絲=乾絲
干菜=乾菜
干著=幹著
干著急=乾著急
干裂=乾裂
干買=干買
干買賣=幹買賣
干陽=乾陽
干隆=乾隆
干飯=乾飯
干傻=干傻
干傻事=幹傻事
干嗎=幹嗎
干媽=乾媽
干粮=乾糧
干葉=乾葉
干號=乾號
干路=幹路
干農=干農
干農活=幹農活
干過=幹過
干過一杯=乾過一杯
干過杯=乾過杯
干過癮=乾過癮
干道=幹道
干酪=乾酪
干错=幹錯
干電=干電
干電池=乾電池
干嘔=乾嘔
干嘛=幹嘛
干慣=幹慣
干撇=干撇
干撇下=乾撇下
干盡=幹盡
干盡一杯=乾盡一杯
干盡一壺=乾盡一壺
干盡一碗=乾盡一碗
干盡一壇=乾盡一磹
干綱=干綱
干綱不振=乾綱不振
干麼=幹麼
干數=干數
干數杯=乾數杯
干樁=幹樁
干澗=乾澗
干熬=乾熬
干熱=乾熱
干瘦=乾瘦
干瘪=乾癟
干線=幹線
干練=幹練
干醋=乾醋
干壇=乾罈
干壇主=幹壇主
干壇法=幹壇法
干燒=乾燒
干瘾=乾癮
干辦=幹辦
干錯=幹錯
干嚎=乾嚎
干擱=乾擱
干澀=乾澀
干濕=乾濕
干濕發=乾濕髮
干燥=乾燥
干瞪=乾瞪
干聲=乾聲
干薪=乾薪
干點=幹點
干糧=乾糧
干壞=干壞
干壞事=幹壞事
干癟=乾癟
干警=幹警
干癮=乾癮
干曬=乾曬
广布=廣佈
广征=廣徵
才干=才幹
才干了杯=才乾了杯
才干干淨=才乾乾淨
才干旱=才乾旱
才干那杯=才乾那杯
才干杯=才乾杯
才干枯=才乾枯
才干耗=才乾耗
才干脆=才乾脆
才干涸=才乾涸
才干淨=才乾淨
才干爽=才乾爽
才干透=才乾透
才干這杯=才乾這杯
才干著急=才乾著急
才不=才不
才不干杯=才不乾杯
才不干枯=才不乾枯
才不干涸=才不乾涸
才不干渴=才不乾渴
才不干燥=才不乾燥
才松=才松
才松一口氣=才鬆一口氣
才松了=才鬆了
才松下=才鬆下
才松手=才鬆手
才松快=才鬆快
才松放=才鬆放
才松松=才鬆鬆
才松柔=才鬆柔
才松晃=才鬆晃
才松氣=才鬆氣
才松脆=才鬆脆
才松掉=才鬆掉
才松軟=才鬆軟
才松散=才鬆散
才松開=才鬆開
才松懈=才鬆懈
才象=才像
门斗=門鬥
门坎=門檻
门梁=門樑
飞升=飛昇
飞卷=飛捲
马夫=馬伕
马里=馬里
马表=馬錶
马僵=馬韁
不大=不大
不大象=不大像
不干=不干
不干不淨=不乾不淨
不干他=不干他
不干休=不干休
不干她=不干她
不干你=不干你
不干我=不干我
不干系=不干係
不干杯=不乾杯
不干政=不干政
不干涉=不干涉
不干脆=不乾脆
不干淨=不乾淨
不干著急=不乾著急
不干裂=不乾裂
不干預=不干預
不干擾=不干擾
不丑=不醜
不斗=不鬥
不方=不方
不方便=不方便
不并=不併
不余=不餘
不系=不繫
不並=不併
不松=不松
不松下=不鬆下
不松開=不鬆開
不舍=不捨
不采=不採
不要=不要
不要干=不要干
不要象=不要象
不修=不修
不修篇幅=不修邊幅
不值=不值
不值一曬=不值一哂
不涂=不塗
不能=不能
不能干=不能干
不能象=不能象
不能象征=不能象徵
不断=不斷
不寒=不寒
不寒而栗=不寒而慄
不象=不像
不愈=不癒
不當=不當
不當准=不當準
不斷發展=不斷發展
不贊=不讚
不贊同=不贊同
丑一=丑一
丑一點=醜一點
丑人=醜人
丑八=丑八
丑八戒=醜八戒
丑八怪=醜八怪
丑丫=丑丫
丑丫頭=醜丫頭
丑丫鬟=醜丫鬟
丑也=丑也
丑也丑=醜也醜
丑女=醜女
丑小=丑小
丑小子=醜小子
丑小鴨=醜小鴨
丑不=丑不
丑不丑=醜不醜
丑丑=醜醜
丑化=醜化
丑少=丑少
丑少年=醜少年
丑巴=丑巴
丑巴怪=醜巴怪
丑名=醜名
丑如=醜如
丑死=醜死
丑老=醜老
丑老頭=醜老頭
丑行=醜行
丑似=醜似
丑男=醜男
丑事=醜事
丑怪=醜怪
丑東=丑東
丑東西=醜東西
丑的=醜的
丑俊=醜俊
丑陋=醜陋
丑面=醜面
丑家=丑家
丑家伙=醜傢伙
丑鬼=醜鬼
丑婆=醜婆
丑婦=醜婦
丑得=醜得
丑得象=醜得像
丑惡=醜惡
丑詆=醜詆
丑媳=丑媳
丑媳婦=醜媳婦
丑煞=丑煞
丑煞人=醜煞人
丑話=醜話
丑態=醜態
丑漢=醜漢
丑聞=醜聞
丑語=醜語
丑貌=醜貌
丑劇=醜劇
丑模=丑模
丑模樣=醜模樣
丑樣=醜樣
丑聲=醜聲
丑臉=醜臉
丑類=醜類
专干=專幹
专制=專制
中仑=中崙
中布=中佈
中侖=中崙
中岳=中嶽
中签=中籤
中簽=中籤
丰谀=豐腴
丰韵=丰韻
为范=為範
为准=為準
之余=之餘
之准=之準
之欲=之慾
之游=之遊
乌丘=烏坵
乌发=烏髮
乌里=烏里
书台=書檯
书童=書僮
书签=書籤
云吞=雲吞
云南=雲南
云宵=雲霄
云游=雲遊
互斗=互鬥
五天=五天
五扎=五紮
五只=五隻
五谷=五穀
五周=五週
五岳=五嶽
五海=五海
五海裡=五海里
五脏=五臟
五裡=五里
五裡余=五里餘
五髒=五臟
什么=什麼
什幺=什麼
什幺女人=什麼女人
什錦=什錦
什錦面=什錦麵
仅余=僅餘
介系=介系
介系詞=介係詞
介胄=介冑
仍斗=仍鬥
仍象=仍像
仑背=崙背
元凶=元兇
元朝=元朝
元勳=元勛
內斗=內鬥
內函=內涵
內制=內製
內松=內松
內松外緊=內鬆外緊
內哄=內鬨
內裡=內裡
內緊=內緊
內緊外松=內緊外鬆
內髒=內臟
公干=公幹
公历=公曆
公布=公佈
公余=公餘
公国=公國
公厘=公釐
公裡=公里
公歷=公曆
六天=六天
六天后=六天後
六只=六隻
六冲=六衝
六沖=六衝
六周=六週
六海=六海
六海裡=六海里
六欲=六慾
六須=六須
六須鯰=六鬚鯰
六裡=六里
六裡余=六里餘
内斗=內鬥
内函=內涵
内制=內製
内哄=內鬨
内脏=內臟
冗余=冗餘
凤斗=鳳鬥
凶犯=兇犯
凶杀=兇殺
凶徒=兇徒
凶案=兇案
凶惧=兇懼
凶殺=兇殺
凶猛=兇猛
凶嫌=兇嫌
凶懼=兇懼
分布=分佈
分伙=分夥
分別=分別
分象=分像
分量=份量
分道=分道
分道揚鏢=分道揚鑣
分鐘=分鐘
勾干=勾幹
卅余=卅餘
升平=昇平
升华=昇華
升汞=昇汞
升迁=陞遷
升阳=昇陽
升官=陞官
升泰=昇泰
升華=昇華
升陽=昇陽
升遷=陞遷
厄立=厄立
厄立特裡=厄立特里
历书=曆書
历日=曆日
历月=曆月
历法=曆法
历象=曆象
历数=曆數
历落=曆落
双斗=雙鬥
双并=雙併
双周=雙週
双拐=雙枴
反反=反反
反反復復=反反覆覆
反冲=反衝
反朴=反朴
反朴歸真=反璞歸真
反沖=反衝
反卷=反捲
反复=反覆
反復=反覆
天干=天干
天干物燥=天乾物燥
天生=天生
天生干=天生幹
天佑=天祐
天後=天后
天朝=天朝
天象=天象
天翻=天翻
天翻地復=天翻地覆
太干=太乾
太不=太不
太不准=太不準
太丑=太醜
太太=太太
太初=太初
太初歷=太初曆
太松=太鬆
太咸=太鹹
太後=太后
太後面=太後面
太准=太準
太象=太像
太監=太監
夫奸=夫姦
夫役=伕役
少干=少幹
少干系=少干係
少干涉=少干涉
少干預=少干預
少干擾=少干擾
少冲=少衝
少年=少年
少沖=少衝
少海=少海
少海裡=少海里
少裡=少里
尤如=猶如
尤怜=猶憐
尤带=猶帶
尤帶=猶帶
尤裡=尤里
尤疑=猶疑
尤憐=猶憐
尤豫=猶豫
尺余=尺餘
屯扎=屯紮
巴西=巴西
巴厘=峇里
巴爾=巴爾
巴爾干=巴爾幹
巴釐=峇里
廿余=廿餘
开发=開發
开征=開徵
开采=開採
开浚=開濬
开铺=開舖
开辟=開闢
引發=引發
心头=心頭
心系=心繫
心系統=心系統
心底=心底
心底裡=心底裡
心相=心相
心相系=心相繫
心脏=心臟
心理=心理
心細=心細
心細如發=心細如髮
心細似發=心細似髮
心髒=心臟
手一=手一
手一卷=手一捲
手一松=手一鬆
手不=手不
手不松=手不鬆
手松=手鬆
手表=手錶
手表示=手表示
手表現=手表現
手表達=手表達
手表態=手表態
手表演=手表演
手采=手採
手炼=手鍊
手煉=手鍊
手裡=手裡
手裡余=手裡餘
扎了=紮了
扎上=紮上
扎下=紮下
扎扎=紮紮
扎在=紮在
扎好=紮好
扎成=紮成
扎住=紮住
扎囮=紮囮
扎诈=紮詐
扎实=紮實
扎带=紮帶
扎结=紮結
扎根=紮根
扎紧=紮緊
扎起=紮起
扎帶=紮帶
扎彩=紮彩
扎着=紮著
扎脚=紮腳
扎結=紮結
扎著=紮著
扎詐=紮詐
扎腳=紮腳
扎實=紮實
扎寨=紮寨
扎稳=紮穩
扎緊=紮緊
扎营=紮營
扎裹=紮裹
扎營=紮營
扎辫=紮辮
扎穩=紮穩
扎辮=紮辮
支干=支幹
支烟=支菸
支煙=支菸
支签=支籤
支簽=支籤
文丑=文醜
文斗=文鬥
文匯=文匯
文匯報=文匯報
斗！=鬥！
斗一=鬥一
斗一斗=鬥一鬥
斗了=鬥了
斗了一斗=鬥了一鬥
斗力=鬥力
斗十=斗十
斗十余=鬥十餘
斗上=鬥上
斗上一斗=鬥上一鬥
斗下=斗下
斗下去=鬥下去
斗个=鬥個
斗久=鬥久
斗口=鬥口
斗士=鬥士
斗不=鬥不
斗不過=鬥不過
斗什=斗什
斗什麼=鬥什麼
斗內=斗內
斗內力=鬥內力
斗心=鬥心
斗斗=鬥鬥
斗气=鬥氣
斗牛=鬥牛
斗他=鬥他
斗他一斗=鬥他一鬥
斗出=鬥出
斗去=鬥去
斗本=斗本
斗本事=鬥本事
斗争=鬥爭
斗传=鬥傳
斗在=鬥在
斗场=鬥場
斗她=鬥她
斗她一斗=鬥她一鬥
斗成=鬥成
斗杀=鬥殺
斗毕=鬥畢
斗百=斗百
斗百余=鬥百餘
斗你=鬥你
斗劲=鬥勁
斗妍=鬥妍
斗完=鬥完
斗弄=鬥弄
斗忍=鬥忍
斗志=鬥志
斗快=鬥快
斗我=鬥我
斗批=鬥批
斗技=鬥技
斗来=鬥來
斗灼=斗杓
斗私=鬥私
斗艺=鬥藝
斗角=鬥角
斗过=鬥過
斗饮=鬥飲
斗鸡=鬥雞
斗丽=鬥麗
斗來=鬥來
斗到=鬥到
斗命=鬥命
斗奇=鬥奇
斗定=斗定
斗定力=鬥定力
斗招=鬥招
斗殴=鬥毆
斗法=鬥法
斗爭=鬥爭
斗狗=鬥狗
斗的=斗的
斗的過=鬥的過
斗败=鬥敗
斗闹=鬥鬧
斗鱼=鬥魚
斗剑=鬥劍
斗勁=鬥勁
斗勇=鬥勇
斗垮=鬥垮
斗战=鬥戰
斗拱=斗栱
斗狠=鬥狠
斗胜=鬥勝
斗個=鬥個
斗倒=鬥倒
斗将=鬥將
斗恶=鬥惡
斗拳=鬥拳
斗敌=鬥敵
斗氣=鬥氣
斗神=鬥神
斗舰=鬥艦
斗艳=鬥豔
斗草=鬥草
斗起=鬥起
斗酒=鬥酒
斗兽=鬥獸
斗將=鬥將
斗得=鬥得
斗敗=鬥敗
斗殺=鬥殺
斗畢=鬥畢
斗眼=鬥眼
斗着=鬥著
斗魚=鬥魚
斗勝=鬥勝
斗場=鬥場
斗就=斗就
斗就斗=鬥就鬥
斗惡=鬥惡
斗掌=鬥掌
斗智=鬥智
斗棋=鬥棋
斗然=陡然
斗著=鬥著
斗飲=鬥飲
斗傳=鬥傳
斗意=鬥意
斗输=鬥輸
斗過=鬥過
斗魂=鬥魂
斗劍=鬥劍
斗嘴=鬥嘴
斗敵=鬥敵
斗毆=鬥毆
斗趣=鬥趣
斗鬧=鬥鬧
斗戰=鬥戰
斗擞=抖擻
斗機=斗機
斗機智=鬥機智
斗輸=鬥輸
斗蟋=斗蟋
斗蟋蟀=鬥蟋蟀
斗赢=鬥贏
斗擻=抖擻
斗雞=鬥雞
斗獸=鬥獸
斗藝=鬥藝
斗鵪=斗鵪
斗鵪鶉=鬥鵪鶉
斗麗=鬥麗
斗艦=鬥艦
斗贏=鬥贏
斗豔=鬥豔
方便=方便
方便面=方便麵
无余=無餘
无梁=無樑
无欲=無慾
日干=日干
日干夜干=日幹夜幹
日升=日昇
日历=日曆
日本=日本
日本制=日本製
日本制定=日本制定
日本制訂=日本制訂
日余=日餘
日志=日誌
日制=日製
日制定=日制定
日制訂=日制訂
日游=日遊
日歷=日曆
日歷史=日歷史
日歷年=日歷年
日歷經=日歷經
月历=月曆
月余=月餘
月歷=月曆
木纳=木訥
木制=木製
木拐=木枴
木納=木訥
木梁=木樑
木签=木籤
木簽=木籤
欠准=欠準
比斗=比鬥
比拼=比拚
毛发=毛髮
毛制=毛製
毛姜=毛薑
毛须=毛鬚
毛發=毛髮
毛須=毛鬚
毛裡=毛裡
毛裡求斯=毛里求斯
毛裡裘斯=毛里裘斯
气郁=氣鬱
气慨=氣概
水一=水一
水一沖=水一衝
水又=水又
水又沖=水又衝
水已=水已
水已干=水已乾
水已沖=水已衝
水干=水乾
水干掉=水乾掉
水干盡=水乾盡
水才=水才
水才干=水才乾
水再=水再
水再沖=水再衝
水沖=水沖
水谷=水谷
水谷之海=水穀之海
水泄=水泄
水泄不通=水洩不通
水急=水急
水急沖=水急衝
水准=水準
水清=水清
水清可見=水清可鑑
水道=水道
水濂=水簾
火折=火摺
火拼=火拚
火签=火籤
火簽=火籤
片言=片言
片言只語=片言隻語
片姜=片薑
片紙=片紙
片紙只字=片紙隻字
牙签=牙籤
牙簽=牙籤
牛只=牛隻
牛柳=牛柳
牛柳面=牛柳麵
犬只=犬隻
王国=王國
王後=王后
计划=計畫
计准=計準
订制=訂製
认准=認準
贝里=貝里
车夫=車伕
车游=車遊
韦后=韋后
韦席=韋蓆
风干=風乾
风刮=風颳
风卷=風捲
风范=風範
且斗=且斗
且斗且=且鬥且
世界=世界
世界杯=世界盃
业余=業餘
东升=東昇
东冲=東衝
东里=東里
东岳=東嶽
东征=東征
东涌=東涌
东游=東遊
丝制=絲製
丝弦=絲絃
主干=主幹
他干=他幹
他干一杯=他乾一杯
他干女兒=他乾女兒
他干兒子=他乾兒子
他干涉=他干涉
他干爹=他乾爹
他干脆=他乾脆
他干淨=他乾淨
他干預=他干預
他干擾=他干擾
他不=他不
他不干渴=他不乾渴
他丑=他醜
他白=他白
他白干=他白幹
他象=他像
他象征戰=他像征戰
付托=付託
仙後=仙后
仙范=仙範
仙游=仙遊
代征=代徵
代理=代理
令媛=令嬡
仪范=儀範
们干=們幹
充飢=充飢
充飢畫餅=充饑畫餅
冬台=冬颱
出了=出了
出了丑=出了醜
出丑=出醜
出征=出征
出的=出的
出的丑=出的醜
出籴=出糶
出個=出個
出個丑=出個醜
出游=出遊
出過=出過
出過丑=出過醜
出電=出電
出電影=齣電影
出槌=出鎚
出糴=出糶
功勳=功勛
功虧=功虧
功虧一匱=功虧一簣
加上=加上
加卷=加捲
加涂=加塗
加裡=加里
包扎=包紮
包谷=包穀
包函=包涵
包卷=包捲
包准=包準
北冲=北衝
北回=北迴
北沖=北衝
北岳=北嶽
北征=北征
北游=北遊
北極=北極
北極象=北極象
北裡=北里
半干=半乾
半只=半隻
占士=佔士
占风=佔風
占有=佔有
卡裡=卡里
卯上=卯上
卯上干=卯上幹
去干=去幹
去干一杯=去乾一杯
去干了杯=去乾了杯
去干洗=去乾洗
去干耗=去乾耗
去干淨=去乾淨
去干著急=去乾著急
去卷=去捲
发小=髮小
发干=發乾
发丝=髮絲
发布=發佈
发长=髮長
发夹=髮夾
发式=髮式
发色=髮色
发束=髮束
发针=髮針
发乳=髮乳
发卷=髮卷
发妻=髮妻
发姐=髮姐
发油=髮油
发肤=髮膚
发质=髮質
发钗=髮釵
发际=髮際
发饰=髮飾
发冠=髮冠
发型=髮型
发带=髮帶
发指=髮指
发面=發麵
发香=髮香
发套=髮套
发根=髮根
发梳=髮梳
发胶=髮膠
发梢=髮梢
发笺=髮箋
发廊=髮廊
发皓=髮皓
发菜=髮菜
发箍=髮箍
发缨=髮纓
发蜡=髮蠟
发醅=醱醅
发髯=髮髯
发雕=髮雕
发髻=髮髻
发辫=髮辮
发霜=髮霜
发簪=髮簪
发鬓=髮鬢
古朴=古樸
古法=古法
古法自制=古法自製
古迹=古蹟
古雲=古云
古跡=古蹟
另辟=另闢
只大=只大
只大老鼠=隻大老鼠
只马=隻馬
只凤=隻鳳
只手=隻手
只牛=隻牛
只犬=隻犬
只巨=只巨
只巨獸=隻巨獸
只母=只母
只母老虎=隻母老虎
只鸟=隻鳥
只字=隻字
只羊=隻羊
只老=只老
只老狐狸=隻老狐狸
只老虎=隻老虎
只老鼠=隻老鼠
只余=只餘
只言=只言
只言片字=隻言片字
只言片語=隻言片語
只身=隻身
只身分=隻身份
只驴=隻驢
只鸡=隻雞
只兔=隻兔
只怪=只怪
只怪物=隻怪物
只怪獸=隻怪獸
只招=只招
只招子=隻招子
只狐=只狐
只狐狸=隻狐狸
只狗=隻狗
只虎=隻虎
只狮=隻獅
只涂=只塗
只狼=隻狼
只畜=只畜
只畜生=隻畜生
只馬=隻馬
只鬼=隻鬼
只鸭=隻鴨
只猛=只猛
只猛獸=隻猛獸
只眼=隻眼
只蛋=隻蛋
只野=只野
只野獸=隻野獸
只鳥=隻鳥
只鹿=隻鹿
只猪=隻豬
只猫=隻貓
只猴=隻猴
只鹅=隻鵝
只獅=隻獅
只骡=隻騾
只鳳=隻鳳
只影=隻影
只豬=隻豬
只貓=隻貓
只鴨=隻鴨
只聲=只聲
只聲不出=隻聲不出
只雞=隻雞
只鵝=隻鵝
只鹰=隻鷹
只騾=隻騾
只鷹=隻鷹
只驢=隻驢
叫於=叫于
叮叮=叮叮
叮叮當當=叮叮噹噹
叮当=叮噹
叮當=叮噹
可干=可干
可干衣=可乾衣
可干拭=可乾拭
可干洗=可乾洗
可干飲=可乾飲
可干製=可乾製
可干擦=可乾擦
可干濕=可乾濕
可干燥=可乾燥
可以=可以
可以干涉=可以干涉
可以干預=可以干預
可以干擾=可以干擾
可以象=可以像
可余=可餘
可采=可採
可象=可像
可象征戰=可像征戰
可緊=可緊
可緊可松=可緊可鬆
可贊=可讚
台子=檯子
台干=台幹
台历=檯曆
台风=颱風
台布=檯布
台布下=台佈下
台布告=台佈告
台布防=台佈防
台布置=台佈置
台布署=台佈署
台布道=台佈道
台布滿=台佈滿
台灯=檯燈
台制=台製
台钟=檯鐘
台面=檯面
台風=颱風
台球=檯球
台凳=檯凳
台歷=檯曆
台燈=檯燈
台鐘=檯鐘
台灣=台灣
台灣制=台灣製
台灣制定=台灣制定
台灣制度=台灣制度
台灣制訂=台灣制訂
史迹=史蹟
史跡=史蹟
右冲=右衝
右沖=右衝
号志=號誌
叹为=歎為
叹服=歎服
叹羡=歎羨
叹赏=歎賞
叼扰=叨擾
叼难=刁難
叼擾=叨擾
叼難=刁難
四天=四天
四扎=四紮
四只=四隻
四舍=四捨
四個=四個
四海=四海
四海裡=四海里
四裡=四里
四裡余=四里餘
圣叹=聖歎
圣杯=聖盃
圣迹=聖蹟
圣象=聖像
处理=處理
外制=外製
外松=外松
外松內緊=外鬆內緊
外涂=外塗
外強=外強
外強中干=外強中乾
外御=外御
外御強敵=外禦強敵
失准=失準
头扎=頭紮
头发=頭髮
宁舍=寧捨
它象=它像
对干=對幹
对准=對準
对象=對象
左冲=左衝
左沖=左衝
巧干=巧幹
巨子=鉅子
巨制=巨製
巨细=鉅細
巨须=巨鬚
巨細=鉅細
巨細靡遺=鉅細靡遺
巨鹿=鉅鹿
巨須=巨鬚
布一=布一
布一個=佈一個
布个=佈個
布于=佈於
布伏=佈伏
布导=佈導
布兵=佈兵
布告=佈告
布坛=佈壇
布局=佈局
布岗=佈崗
布谷=布穀
布防=佈防
布阵=佈陣
布於=佈於
布施=佈施
布個=佈個
布陣=佈陣
布崗=佈崗
布着=佈著
布景=佈景
布著=佈著
布满=佈滿
布置=佈置
布署=佈署
布裡=布里
布裡斯托=布里斯托
布雷=佈雷
布滿=佈滿
布疑=布疑
布疑陣=佈疑陣
布壇=佈壇
布導=佈導
平台=平台
平准=平準
弘历=弘曆
弘歷=弘曆
归并=歸併
归朴=歸璞
归究=歸咎
归里=歸里
必游=必遊
必須=必須
必須品=必需品
戊卫=戌衛
戊戍=戊戌
戊衛=戌衛
扑卷=撲捲
打不=打不
打不准=打不準
打斗=打鬥
打谷=打穀
打制=打製
打拼=打拚
旧历=舊曆
旧游=舊遊
未干=未乾
未斗=未鬥
未松=未松
未松下=未鬆下
未松口=未鬆口
未愈=未癒
未端=末端
本周=本週
本国=本國
正正=正正
正正當當=正正當當
正象=正像
母丑=母醜
母後=母后
母范=母範
民制=民製
民国=民國
永历=永曆
永志=永誌
永歷=永曆
汇刊=彙刊
汇总=彙總
汇编=彙編
汇萃=薈萃
汇集=彙集
汇辑=彙輯
汇整=彙整
汇纂=彙纂
汉国=漢國
汉朝=漢朝
玉佩=玉珮
玉制=玉製
甘乃=甘乃
甘乃迪=甘迺迪
甘薯=甘藷
生力=生力
生力面=生力麵
生克=生剋
生長=生長
生姜=生薑
生得=生得
生得丑=生得醜
生理=生理
生發=生發
生發水=生髮水
生發藥=生髮藥
甩发=甩髮
甩發=甩髮
甲胄=甲冑
电杆=電杆
白发=白髮
白术=白朮
白白=白白
白白干=白白幹
白面=白面
白面無須=白面無鬚
白须=白鬚
白淅=白皙
白術=白朮
白發=白髮
白須=白鬚
白澈=白皙
皮制=皮製
皮松=皮鬆
目我=目我
目我於思=目我于思
目定=目定
目定口呆=目瞪口呆
石制=石製
石英=石英
石英表=石英錶
石英鐘=石英鍾
石梁=石樑
石象=石像
石膏=石膏
石膏象=石膏像
示范=示範
长台=長檯
长征=長征
长须=長鬚
长象=長像
闪铄=閃爍
饥年=饑年
饥荒=饑荒
饥馑=饑饉
龙钟=龍鍾
龙须=龍鬚
丟了=丟了
丟了丑=丟了醜
丟丑=丟醜
买凶=買兇
买姜=買薑
买烟=買菸
争斗=爭鬥
亚里=亞里
交托=交託
交游=交遊
亦舍=亦舍
亦舍下=亦捨下
亦雲=亦云
仰冲=仰衝
仰沖=仰衝
仿佛=彷彿
仿制=仿製
仿徉=彷徉
仿效=倣傚
仿徨=徬徨
休克=休克
优游=優遊
伙夫=伙伕
伙计=夥計
伙众=夥眾
伙同=夥同
伙伴=夥伴
伙計=夥計
伙眾=夥眾
会干=會幹
会斗=會鬥
会象=會像
传布=傳佈
传赞=傳贊
伤愈=傷癒
先干=先干
先干為敬=先乾為敬
先奸=先姦
光念=光唸
光致=光致
光致致=光緻緻
全日=全日
全日制=全日制
全台=全台
全象=全像
全裡=全里
共斗=共鬥
共制=共製
共御=共禦
兲朝=兲朝
关系=關係
关注=關注
再干=再幹
再干一杯=再乾一杯
再丑=再醜
再斗=再鬥
再斗一斗=再鬥一鬥
再斗斗=再鬥鬥
再冲=再衝
再沖=再衝
再制=再製
再卷=再捲
再松=再鬆
再象=再像
农历=農曆
农获=農穫
冲！=衝！
冲入=衝入
冲力=衝力
冲下=衝下
冲口=衝口
冲门=衝門
冲天=衝天
冲开=衝開
冲心=衝心
冲风=衝風
冲他=衝他
冲出=衝出
冲击=衝擊
冲去=衝去
冲扑=衝撲
冲犯=衝犯
冲穴=衝穴
冲军=衝軍
冲决=衝決
冲动=衝動
冲向=衝向
冲回=衝回
冲她=衝她
冲杀=衝殺
冲至=衝至
冲闯=衝闖
冲驰=衝馳
冲乱=衝亂
冲你=衝你
冲克=衝剋
冲劲=衝勁
冲呀=衝呀
冲坚=衝堅
冲坠=衝墜
冲我=衝我
冲来=衝來
冲过=衝過
冲阵=衝陣
冲到=衝到
冲刺=衝刺
冲势=衝勢
冲奔=衝奔
冲往=衝往
冲波=衝波
冲近=衝近
冲进=衝進
冲冠=衝冠
冲剌=衝剌
冲前=衝前
冲剑=衝劍
冲咱=衝咱
冲突=衝突
冲脉=衝脈
冲要=衝要
冲倒=衝倒
冲将=衝將
冲拳=衝拳
冲浪=衝浪
冲破=衝破
冲起=衝起
冲啊=衝啊
冲掠=衝掠
冲断=衝斷
冲着=衝著
冲陷=衝陷
冲然=衝然
冲程=衝程
冲著=衝著
冲越=衝越
冲跑=衝跑
冲量=衝量
冲锋=衝鋒
冲落=衝落
冲错=衝錯
冲撞=衝撞
冲激=衝激
决斗=決鬥
决择=抉擇
刑余=刑餘
划龙=划龍
划来=划來
划独=划獨
划桨=划槳
则采=則採
则象=則像
创制=創製
动荡=動盪
印制=印製
印象=印象
印象是=印象是
吃干=吃乾
吃干了=吃乾了
吃不=吃不
吃不准=吃不準
吃完=吃完
吃完面=吃完麵
吃面=吃麵
吃准=吃準
吃茶=喫茶
吃著=吃著
吃過=吃過
吃過面=吃過麵
各干=各干
各干各=各幹各
各国=各國
合斗=合鬥
合伙=合夥
合并=合併
合並=合併
合並不=合並不
合並且=合並且
合並非=合並非
合府=闔府
合眼=闔眼
合第=闔第
吉佔=吉占
吉裡=吉里
吊书=弔書
吊文=弔文
吊古=弔古
吊民=弔民
吊民伐罪=弔民伐罪
吊场=弔場
吊死=吊死
吊死問疾=弔死問疾
吊考=弔考
吊问=弔問
吊孝=弔孝
吊系=吊繫
吊词=弔詞
吊丧=弔喪
吊取=弔取
吊念=弔念
吊诡=弔詭
吊信=弔信
吊客=弔客
吊贺=弔賀
吊唁=弔唁
吊書=弔書
吊钱=弔錢
吊問=弔問
吊祭=弔祭
吊喉=弔喉
吊喪=弔喪
吊場=弔場
吊奠=弔奠
吊詞=弔詞
吊賀=弔賀
吊詭=弔詭
吊旗=弔旗
吊膀=吊膀
吊膀子=弔膀子
吊影=弔影
吊慰=弔慰
吊錢=弔錢
同仇=同仇
同仇敵慨=同仇敵愾
同伙=同夥
同游=同遊
名字=名字
名字是於=名字是于
名迹=名蹟
名跡=名蹟
后奸=後姦
后制=後製
后梁=後樑
后象=後像
后衛=後衛
吐干=吐乾
向午=晌午
向外=向外
向外沖=向外衝
向导=嚮導
向应=嚮應
向往=嚮往
向後=向後
向後沖=向後衝
向准=向準
向導=嚮導
向導游=嚮導遊
向應=嚮應
吕后=呂后
回历=回曆
回文=回文
回文詩=迴文詩
回风=迴風
回光=回光
回光反照=迴光反照
回光返照=迴光返照
回冲=回衝
回沖=回衝
回纹=迴紋
回肠=迴腸
回卷=回捲
回环=迴環
回响=迴響
回复=回覆
回绕=迴繞
回風=迴風
回紋=迴紋
回圈=迴圈
回旋=迴旋
回報=回報
回廊=迴廊
回復=回覆
回游=迴游
回然=迥然
回翔=迴翔
回荡=迴蕩
回陽=回陽
回陽蕩氣=迴陽蕩氣
回傭=回佣
回腸=迴腸
回腸蕩氣=迴腸蕩氣
回誦=迴誦
回銮=迴鑾
回歷=回曆
回蕩=迴蕩
回環=迴環
回避=迴避
回繞=迴繞
回響=迴響
回響當=迴響當
回鑾=迴鑾
因奸=因奸
因奸成孕=因姦成孕
团子=糰子
团伙=團夥
团粉=糰粉
地一=地一
地一卷=地一捲
地干=地干
地干吧=地幹吧
地干杯=地乾杯 
地干裂=地乾裂
地干燥=地乾燥
地冲=地衝
地志=地誌
地沖=地衝
地卷=地捲
多干=多干
多干了=多乾了
多干干=多乾乾
多干系=多干系
多干杯=多乾杯
多干涉=多干涉
多干脆=多乾脆
多干淨=多乾淨
多干爽=多乾爽
多干預=多干預
多干燥=多乾燥
多干擾=多干擾
多丑=多醜
多少=多少
多少只=多少隻
多出=多出
多出電影=多齣電影
多半只=多半只
多余=多餘
多海=多海
多海裡=多海里
多裡=多里
多麼=多麼
多麼丑=多麼醜
夸尔=夸爾
夸脱=夸脫
夹衣=裌衣
夹袄=裌襖
夺斗=奪鬥
夺杯=奪盃
奸尸=姦屍
奸凶=姦凶
奸夫=姦夫
奸妇=姦婦
奸杀=姦殺
奸污=姦污
奸拐=姦拐
奸屍=姦屍
奸婦=姦婦
奸情=姦情
奸殺=姦殺
奸淫=姦淫
奸盗=姦盜
奸通=姦通
奸盜=姦盜
她干=她幹
她干女兒=她乾女兒
她干兒子=她乾兒子
她干涉=她干涉
她干爹=她乾爹
她干脆=她乾脆
她干淨=她乾淨
她干預=她干預
她干擾=她干擾
她丑=她醜
她象=她像
好干=好幹
好丑=好醜
好斗=好鬥
好好=好好
好好干=好好幹
好好地干=好好地幹
好困=好困
好困吧=好睏吧
好困啊=好睏啊
好咸=好鹹
好准=好準
好烟=好菸
好象=好像
好煙=好菸
好签=好籤
好像征式=好象徵式
好像征性=好象徵性
好簽=好籤
如何=如何
如何干=如何幹
如坐=如坐
如坐針毯=如坐針氈
如果=如果
如果象=如果像
字汇=字彙
字匯=字彙
存折=存摺
宅弟=宅第
宅紫=奼紫
守御=守禦
安全=安全
寻准=尋準
寻麻=蕁麻
导游=導遊
尽干=盡幹
尽先=儘先
尽早=儘早
尽是=儘是
尽够=儘夠
尽教=儘教
尽量=儘量
尽管=儘管
师范=師範
年历=年曆
年余=年餘
年准=年准
年准到=年準到
年歷=年曆
年歷史=年歷史
并入=併入
并力=併力
并合=併合
并负=併負
并吞=併吞
并图=併圖
并拢=併攏
并购=併購
并采=並採
并陇=併攏
并砌=併砌
并科=併科
并案=併案
并赃=併贓
并除=併除
并叠=併疊
弛骋=馳騁
弛騁=馳騁
当当=噹噹
当托=當托
当周=當週
当郎=噹啷
当准=當準
当啷=噹啷
戏扎=戲紮
戏彩=戲綵
成長=成長
托了=託了
托人=託人
托大=託大
托付=託付
托古=託古
托买=託買
托交=託交
托名=託名
托言=託言
托词=託詞
托身=託身
托过=託過
托事=託事
托卖=託賣
托咎=託咎
托孤=託孤
托运=託運
托故=託故
托疾=託疾
托病=託病
托梦=託夢
托詞=託詞
托買=託買
托辞=託辭
托運=託運
托過=託過
托夢=託夢
托管=託管
托賣=託賣
托辭=託辭
扛丸=摃丸
扛龟=摃龜
扛龜=摃龜
扣准=扣準
扫卷=掃捲
扫描=掃瞄
收采=收採
收获=收穫
收獲=收穫
早占=早佔
早佔勿藥=早占勿藥
旬余=旬餘
曲卷=曲捲
曲酒=麴酒
曲薛=麴薛
有出=有出
有出好戲=有齣好戲
有余=有餘
有得=有得
有得斗=有得鬥
有象=有像
有象征=有象徵
有感=有感
有感而雲=有感而云
有點=有點
有點丑=有點醜
有關=有關
有關系=有關係
朱批=硃批
朱矶=硃磯
朱砂=硃砂
朱笔=硃筆
朱喻=硃喻
朱筆=硃筆
朱磯=硃磯
朴玉=璞玉
朴学=樸學
朴实=樸實
朴拙=樸拙
朴直=樸直
朴质=樸質
朴修=朴修
朴修斯=樸修斯
朴素=樸素
朴野=樸野
朴實=樸實
朴質=樸質
朴學=樸學
机抒=機杼
杂志=雜誌
权斗=權鬥
此丑=此醜
死斗=死鬥
死准=死準
汗国=汗國
污蔑=污衊
汤团=湯糰
汤面=湯麵
灯彩=燈綵
灰发=灰髮
灰尽=灰燼
灰胡=灰鬍
灰郁=灰鬱
灰發=灰髮
灰盡=灰燼
灰蒙=灰濛
百天=百天
百天后=百天後
百扎=百紮
百只=百隻
百余=百餘
百余只=百餘隻
百余裡=百餘里
百姓=百姓
百姓於=百姓於
百拙=百拙
百拙千丑=百拙千醜
百海=百海
百海裡=百海里
百裡=百里
竹杆=竹竿
竹制=竹製
竹席=竹蓆
竹框=竹筐
竹荀=竹筍
竹桿=竹竿
竹签=竹籤
竹簽=竹籤
竹藤=竹籐
米余=米餘
米谷=米穀
糸於=糸於
糸於一線=繫於一線
纡回=紆迴
纡余=紆餘
纡郁=紆鬱
红签=紅籤
纤夫=縴夫
约斗=約鬥
约雇=約僱
纨绔=紈袴
纨袴=紈褲
纪历=紀曆
网志=網誌
网游=網遊
老丑=老醜
老且=老且
老且丑=老且醜
老板=老闆
老姜=老薑
老麼=老么
考卷=考卷
考征=考徵
而云=而云
而云然雲=而云然
而云詩雲=而云詩
而云爾雲=而云爾
而象=而像
肉干=肉乾
肉松=肉鬆
肉面=肉麵
肉欲=肉慾
肉絲=肉絲
肉絲面=肉絲麵
自助=自助
自助游=自助遊
自采=自採
自愈=自癒
自贊=自讚
舌一=舌一
舌一卷=舌一捲
舟揖=舟楫
色欲=色慾
血已=血已
血已干=血已乾
血才=血才
血才干=血才乾
血斗=血鬥
行凶=行兇
行李=行李
行李卷=行李捲
行事=行事
行事歷=行事曆
行屍=行尸
行游=行遊
衣驱=衣袪
衣物=衣物
衣物已干=衣物已乾
衣物漸干=衣物漸乾
衣衫=衣衫
衣衫已干=衣衫已乾
衣驅=衣袪
西历=西曆
西冲=西衝
西沖=西衝
西周=西周
西岳=西嶽
西征=西征
西昆=西崑
西後=西后
西游=西遊
西裝=西裝
西裝畢挺=西裝筆挺
西裡=西里
西歷=西曆
观斗=觀鬥
观采=觀採
论赞=論贊
轨范=軌範
辽沈=遼瀋
辽国=遼國
辽亮=嘹喨
页签=頁籤
齐冲=齊衝
齐国=齊國
两天=兩天
两只=兩隻
两里=兩里
两周=兩週
乱斗=亂鬥
乱冲=亂衝
亩余=畝餘
估不=估不
估不准=估不準
伴伙=伴夥
伴游=伴遊
伶敏=靈敏
伸卷=伸捲
伺奉=侍奉
似松=似松
似松實緊=似鬆實緊
但雲=但云
低迥=低迴
低荡=低盪
低蕩=低盪
住扎=住紮
体制=體制
体征=體徵
体范=體範
佔人=占人
佔卜=占卜
佔士邦=占士邦
佔有欲=佔有慾
佔身=占身
佔卦=占卦
佔拜=占拜
佔星=占星
佔風使帆=占風使帆
佔候=占候
佔射=占射
佔夢=占夢
佔鳳=占鳳
佔課=占課
佔親=占親
佔斷=占斷
佔驗=占驗
余人=餘人
余力=餘力
余丈=餘丈
余下=餘下
余刃=餘刃
余子=餘子
余子碌碌=餘子碌碌
余寸=餘寸
余匹=餘匹
余天=餘天
余尺=餘尺
余日=餘日
余月=餘月
余气=餘氣
余水=餘水
余风=餘風
余只=餘隻
余生=餘生
余众=餘眾
余光=餘光
余光中=余光中
余兴=餘興
余名=餘名
余地=餘地
余字=餘字
余存=餘存
余岁=餘歲
余年=餘年
余庆=餘慶
余次=餘次
余亩=餘畝
余位=餘位
余低=餘低
余利=餘利
余劲=餘勁
余沥=餘瀝
余里=餘裡
余闲=餘閒
余饭=餘飯
余事=餘事
余势=餘勢
余味=餘味
余弦=餘弦
余杭=餘杭
余枝=餘枝
余波=餘波
余物=餘物
余线=餘線
余者=餘者
余责=餘責
余勁=餘勁
余勇=餘勇
余姚=餘姚
余威=餘威
余怒=餘怒
余恨=餘恨
余殃=餘殃
余毒=餘毒
余点=餘點
余脉=餘脈
余音=餘音
余風=餘風
余香=餘香
余党=餘黨
余匪=餘匪
余孬=餘孬
余座=餘座
余息=餘息
余晖=餘暉
余氣=餘氣
余海=余海
余海裡=餘海里
余烈=餘烈
余烬=餘燼
余热=餘熱
余畝=餘畝
余缺=餘缺
余脈=餘脈
余贼=餘賊
余载=餘載
余钱=餘錢
余悸=餘悸
余情=餘情
余桶=餘桶
余眾=餘眾
余責=餘責
余部=餘部
余骑=餘騎
余剩=餘剩
余愤=餘憤
余款=餘款
余温=餘溫
余祸=餘禍
余荫=餘蔭
余辜=餘辜
余閒=餘閒
余飯=餘飯
余僇=餘僇
余勢=餘勢
余数=餘數
余暇=餘暇
余暉=餘暉
余歲=餘歲
余溫=餘溫
余粮=餘糧
余裕=餘裕
余裡=餘裡
余賊=餘賊
余路=餘路
余載=餘載
余韵=餘韻
余僧=餘僧
余廕=餘廕
余漏=餘漏
余禍=餘禍
余慶=餘慶
余憤=餘憤
余數=餘數
余熱=餘熱
余線=餘線
余蔭=餘蔭
余輝=餘輝
余辉=餘輝
余震=餘震
余额=餘額
余興=餘興
余錢=餘錢
余點=餘點
余燼=餘燼
余糧=餘糧
余額=餘額
余騎=餘騎
余瀝=餘瀝
余羹=餘羹
余韻=餘韻
余孽=餘孽
余黨=餘黨
佛历=佛曆
佛象=佛像
佛歷=佛曆
作奸=作奸
作奸犯科=作姦犯科
作的=作的
作的准=作的準
作准=作準
作崇=作祟
作廢=作廢
作廢後=作廢後
你干=你幹
你干一杯=你乾一杯
你干女兒=你乾女兒
你干那杯=你乾那杯
你干兒子=你乾兒子
你干涉=你干涉
你干爹=你乾爹
你干脆=你乾脆
你干預=你干預
你干擾=你干擾
你丑=你醜
你白=你白
你白干=你白幹
你象=你像
佣钱=佣錢
克夫=剋夫
克日=剋日
克扣=剋扣
克死=剋死
克克=剋剋
克星=剋星
克苦=刻苦
克剜=剋剜
克期=剋期
克裡=克里
克裡斯多=克里斯多
克裡斯托=克里斯托
克薄=剋薄
免征=免徵
兵签=兵籤
兵簽=兵籤
冶游=冶遊
別干=別幹
別干杯=別乾杯
別干涉=別干涉
別干淨=別乾淨
別干爽=別乾爽
別干裂=別乾裂
別干預=別干預
別干燥=別乾燥
別干擾=別干擾
別斗=別鬥
別扭=彆扭
別扭來=別扭來
別拗=彆拗
別致=別緻
別氣=彆氣
別腳=彆腳
刨刀=鉋刀
刨子=鉋子
刨冰=鉋冰
刨成=鉋成
刨花=鉋花
刨削=鉋削
利欲=利慾
别干=別幹
别斗=別鬥
别气=彆氣
别扭=彆扭
别拗=彆拗
别致=別緻
别脚=彆腳
助理=助理
劫余=劫餘
劭雍=邵雍
劲斗=勁鬥
劳骚=牢騷
匣钵=匣砵
匣缽=匣砵
卤水=滷水
卤汁=滷汁
卤肉=滷肉
卤鸡=滷雞
卤制=滷製
卤味=滷味
卤面=滷麵
卤蛋=滷蛋
卤菜=滷菜
卤鹅=滷鵝
卤酱=滷醬
即象=即像
即像征服=即像征服
即像限制=即像限制
却象=卻像
县志=縣誌
君子=君子
君子好求=君子好逑
吞并=吞併
吞並=吞併
吞咽=吞嚥
吟游=吟遊
吧台=吧檯
吮干=吮乾
吴国=吳國
吵斗=吵鬥
吸干=吸乾
吸烟=吸菸
吸得=吸得
吸得干干=吸得乾乾
吸煙=吸菸
吹干=吹乾
吹发=吹髮
吹卷=吹捲
吹胡=吹鬍
吹须=吹鬚
吹發=吹髮
吹須=吹鬚
呂後=呂后
呆致=呆致
呆致致=呆緻緻
告別=告別
告侥=告饒
告僥=告饒
困乏=睏乏
困倦=睏倦
困意=睏意
困獸=困獸
困獸之斗=困獸之鬥
困獸斗=困獸鬥
困獸猶斗=困獸猶鬥
均沾=均霑
坎顶=崁頂
坎頂=崁頂
坏签=壞籤
坐著=坐著
坛子=罈子
坛酒=罈酒
坛醋=罈醋
坛騞=罈騞
坠胎=墮胎
夾衣=裌衣
夾襖=裌襖
宋国=宋國
宋朝=宋朝
宏基=宏碁
寿面=壽麵
局促=侷促
局限=侷限
局蹙=跼蹙
局躅=跼躅
岛炼=島鍊
巡戈=巡弋
巡回=巡迴
巡游=巡遊
巫咸=巫咸
希拉=希拉
希拉裡=希拉里
庇裡=庇裡
庇裡牛斯=庇里牛斯
床席=床蓆
床第=床笫
应征=應徵
应象=應像
弃舍=棄捨
弄干=弄乾
弄松=弄鬆
弄面=弄面
弄面吃=弄麵吃
形單=形單
形單影只=形單影隻
形象=形象
形影=形影
形影相吊=形影相弔
彷佛=彷彿
彷徨=徬徨
忍饥=忍饑
忍飢=忍饑
志庆=誌慶
志异=誌異
志哀=誌哀
志異=誌異
志喜=誌喜
志發=志發
志慶=誌慶
忧郁=憂鬱
快又=快又
快又准=快又準
快干=快干
快干了=快乾了
快干不=快幹不
快干死=快幹死
快干吧=快幹吧
快干完=快幹完
快干事=快幹事
快干杯=快乾杯
快干活=快幹活
快干裂=快乾裂
快干嘛=快幹嘛
快且=快且
快且准=快且準
快冲=快衝
快吃=快吃
快吃干=快吃乾
快而=快而
快而准=快而準
快快=快快
快快干=快快幹
快沖=快衝
快卷=快捲
快松=快松
快松下=快鬆下
快舍=快舍
快舍下=快捨下
快狠=快狠
快狠准=快狠準
快幹=快幹
快幹啊=快幹啊
怀念=懷念
怀表=懷錶
我干=我幹
我干一杯=我乾一杯
我干女兒=我乾女兒
我干兒子=我乾兒子
我干杯=我乾杯
我干涉=我干涉
我干爹=我乾爹
我干脆=我乾脆
我干預=我干預
我干擾=我干擾
我丑=我醜
我白=我白
我白干=我白幹
我朝=我朝
我象=我像
戒烟=戒菸
戒煙=戒菸
扮象=扮像
扶余=扶餘
批斗=批鬥
批注=批註
批复=批覆
批復=批覆
扼塞=阨塞
找不=找不
找不准=找不準
找准=找準
抉別=訣別
抉别=訣別
把方=把方
把方才=把才纔
把你=把你
把你干=把我幹
把姜=把薑
抑制=抑制
抑郁=抑鬱
抓不=抓不
抓不准=抓不準
抓斗=抓鬥
抓奸=抓姦
抓准=抓準
投不=投不
投不准=投不準
投准=投準
抗斗=抗鬥
抗御=抗禦
折》=摺》
折子=摺子
折云=摺云
折冲=折衝
折沖=折衝
折纸=摺紙
折卷=折捲
折扇=摺扇
折紙=摺紙
折痕=摺痕
折叠=摺疊
折裙=摺裙
折疊=摺疊
抚恤=撫卹
抚须=撫鬚
抛准=拋準
护发=護髮
报道=報導
改念=改唸
改采=改採
旱烟=旱菸
旱煙=旱菸
更丑=更醜
更加=更加
更加丑=更加醜
更松=更鬆
更咸=更鹹
更要=更要
更要丑=更要醜
更准=更準
更象=更像
杆面=桿麵
李鐘=李鐘
李鐘郁=李鍾郁
材干=材幹
村落=村落
束发=束髮
束發=束髮
来干=來幹
来范=來範
来象=來像
步步=步步
步步高升=步步高陞
每只=每隻
每周=每週
求知=求知
求知欲=求知慾
求签=求籤
求簽=求籤
汨沒=汩沒
汨没=汩沒
決心=決心
決心干=決心幹
決斗=決鬥
決擇=抉擇
沈阳=瀋陽
沈郁=沈鬱
沈淀=沈澱
沈陽=瀋陽
沉郁=沉鬱
沉淀=沉澱
沒干=沒幹
沒干淨=沒乾淨
沒干頭=沒幹頭
沒白=沒白
沒白干=沒白幹
沒念=沒唸
沒松=沒松
沒松下=沒鬆下
沒松口=沒鬆口
沒松手=沒鬆手
沒准=沒準
沒輒=沒轍
沖！=衝！
沖了=沖了
沖了入=衝了入
沖了上=衝了上
沖了下=衝了下
沖了出=衝了出
沖了來=衝了來
沖了進=衝了進
沖了過=衝了過
沖入=衝入
沖力=衝力
沖上=沖上
沖上來=衝上來
沖下=衝下
沖口=衝口
沖不=沖不
沖不入=衝不入
沖不上=衝不上
沖不下=衝不下
沖不出=衝不出
沖不破=衝不破
沖不進=衝不進
沖不開=衝不開
沖不過=衝不過
沖天=衝天
沖心=衝心
沖他=衝他
沖出=衝出
沖去=衝去
沖犯=衝犯
沖穴=衝穴
沖向=衝向
沖向前=衝向前
沖回=衝回
沖在=沖在
沖在下=衝在下
沖在前=衝在前
沖在最前=衝在最前
沖她=衝她
沖自=沖自
沖自己=衝自己
沖至=衝至
沖你=衝你
沖克=衝克
沖呀=衝呀
沖我=衝我
沖決=衝決
沖沖=沖沖
沖沖沖=衝衝衝
沖來=衝來
沖到=衝到
沖刺=衝刺
沖奔=衝奔
沖往=衝往
沖波=衝波
沖近=衝近
沖門=衝門
沖冠=衝冠
沖剋=衝剋
沖剌=衝剌
沖前=衝前
沖勁=衝勁
沖咱=衝咱
沖盹=沖盹
沖盹兒=衝盹兒
沖突=衝突
沖要=衝要
沖軍=衝軍
沖風=衝風
沖倒=衝倒
沖拳=衝拳
沖浪=衝浪
沖破=衝破
沖脈=衝脈
沖起=衝起
沖陣=衝陣
沖動=衝動
沖啊=衝啊
沖堅=衝堅
沖將=衝將
沖得=沖得
沖得入=衝得入
沖得出=衝得出
沖得進=衝得進
沖得過=衝得過
沖掠=衝掠
沖殺=衝殺
沖陷=衝陷
沖然=衝然
沖程=衝程
沖著=衝著
沖越=衝越
沖跑=衝跑
沖進=衝進
沖量=衝量
沖開=衝開
沖亂=衝亂
沖勢=衝勢
沖落=衝落
沖過=衝過
沖馳=衝馳
沖劍=衝劍
沖墜=衝墜
沖撞=衝撞
沖撲=衝撲
沖鋒=衝鋒
沖鋒槍=衝鋒槍
沖激=衝激
沖錯=衝錯
沖頭=沖頭
沖頭陣=衝頭陣
沖擊=衝擊
沖斷=衝斷
沖闖=衝闖
没干=沒幹
没念=沒唸
没准=沒準
没辄=沒轍
沥干=瀝乾
灵俐=伶俐
灵欲=靈慾
灵幡=靈旛
灸热=炙熱
灸熱=炙熱
狂冲=狂衝
狂沖=狂衝
狂卷=狂捲
狂征=狂徵
狂贊=狂讚
男用=男用
男用表=男用錶
疔伤=療傷
疔傷=療傷
盯准=盯準
禿發=禿髮
秀发=秀髮
秀發=秀髮
私下=私下
私下裡=私下裡
私斗=私鬥
私欲=私慾
系一=系一
系一片=係一片
系一番=係一番
系一種=係一種
系一線=繫一線
系了=繫了
系上=繫上
系个=繫個
系于=繫於
系马=繫馬
系为=係為
系引=係引
系心=繫心
系手=繫手
系乎=繫乎
系囚=繫囚
系争=係爭
系住=繫住
系块=繫塊
系妥=繫妥
系怀=繫懷
系条=繫條
系牢=繫牢
系念=繫念
系於=繫於
系於一發=繫於一髮
系於一線=繫於一線
系爭=係爭
系绊=繫絆
系带=繫帶
系挂=繫掛
系指=係指
系為=係為
系風=系風
系風捕景=係風捕景
系個=繫個
系留=繫留
系紧=繫緊
系起=繫起
系铃=繫鈴
系馬=繫馬
系帶=繫帶
系掛=繫掛
系條=繫條
系着=繫著
系累=係累
系絆=繫絆
系绳=繫繩
系脚=繫腳
系获=係獲
系颈=繫頸
系發=系發
系發帶=繫髮帶
系絲=系絲
系絲帶=繫絲帶
系缆=繫纜
系著=繫著
系塊=繫塊
系数=係數
系缚=繫縛
系腰=繫腰
系腳=繫腳
系辞=繫辭
系鈴=繫鈴
系鈴人=繫鈴人
系緊=繫緊
系裹=繫裹
系數=係數
系膜=繫膜
系鞋=系鞋
系鞋帶=繫鞋帶
系縛=繫縛
系褲=系褲
系褲子=繫褲子
系踵=係踵
系頭=系頭
系頭巾=繫頭巾
系頸=繫頸
系頸闕庭=係頸闕庭
系獲=係獲
系懷=繫懷
系繩=繫繩
系辭=繫辭
系纜=繫纜
纯朴=純樸
纯系=純係
纳征=納徵
纵欲=縱慾
纸扎=紙紮
肖象=肖像
肝脏=肝臟
肝髒=肝臟
肠脏=腸臟
良游=良遊
虬须=虯鬚
角斗=角鬥
角落=角落
评击=抨擊
评注=評註
词汇=詞彙
词余=詞餘
译注=譯註
谷子=穀子
谷仓=穀倉
谷皮=穀皮
谷场=穀場
谷米=穀米
谷麦=穀麥
谷壳=穀殼
谷物=穀物
谷雨=穀雨
谷类=穀類
谷苗=穀苗
谷贱=穀賤
谷倉=穀倉
谷神=穀神
谷粉=穀粉
谷舱=穀艙
谷草=穀草
谷粒=穀粒
谷麥=穀麥
谷場=穀場
谷殼=穀殼
谷粟=穀粟
谷道=穀道
谷稻=穀稻
谷賤=穀賤
谷艙=穀艙
谷類=穀類
豆制=豆製
豆鼓=豆豉
豆腐=豆腐
豆腐干=豆腐乾
豆蔻=荳蔻
貝胄=貝冑
貝裡=貝里
财欲=財慾
赤发=赤髮
赤坎=赤崁
赤發=赤髮
身分=身份
身系=身繫
車夫=車伕
車游=車遊
轩辟=軒闢
轫性=韌性
辛丑=辛丑
迂回=迂迴
过松=過鬆
那么=那麼
那出=那出
那出好戲=那齣好戲
那出電影=那齣電影
那出劇=那齣劇
那出戲=那齣戲
那只=那隻
那只不過=那只不過
那只加=那只加
那只在=那只在
那只多了=那只多了
那只好=那只好
那只有=那只有
那只佔=那只佔
那只是=那只是
那只要=那只要
那只差=那只差
那只缺=那只缺
那只能=那只能
那只夠=那只夠
那只剩=那只剩
那只減=那只減
那只會=那只會
那只需=那只需
那只增=那只增
那伙=那伙
那伙人=那夥人
那里=那裡
那般=那般
那般准=那般準
那麼干=那麼幹
那麼丑=那麼醜
那麼准=那麼準
邪欲=邪慾
里兰=里蘭
里尔=里爾
里长=里長
里亚=里亞
里约=里約
里余=裡餘
里纳=里納
里奥=里奧
里象=裡像
针炙=針灸
针黹=鍼黹
钉槌=釘鎚
闲余=閒餘
闲游=閒遊
闲遐=閒暇
闲静=閑靜
闷头=悶頭
闷郁=悶鬱
阮咸=阮咸
防水=防水
防水表=防水錶
防台=防颱
防台灣=防台灣
防饥=防饑
防范=防範
防飢=防饑
防御=防禦
防碍=妨礙
防礙=妨礙
阳历=陽曆
阴干=陰乾
阴历=陰曆
阴郁=陰鬱
饨面=飩麵
饭团=飯糰
饮干=飲乾
鸡只=雞隻
鸡奸=雞姦
麦面=麥麵
並入=併入
並力=併力
並不=並不
並不並=併不併
並包=并包
並合=併合
並吞=併吞
並肩=並肩
並肩子=併肩子
並肩干=並肩幹
並采=並採
並砌=併砌
並科=併科
並負=併負
並負責=並負責
並案=併案
並除=併除
並發=並發
並發症=併發症
並圖=併圖
並購=併購
並購買=並購買
並攏=併攏
並隴=併攏
並贓=併贓
並贓治罪=併贓治罪
並贓拿賊=併贓拿賊
並疊=併疊
事也=事也
事也干=事也幹
事干=事幹
事干系=事幹係
事干涉=事干涉
事干脆=事乾脆
事干淨=事乾淨
事干預=事干預
事干擾=事干擾
事可=事可
事可干=事可幹
事好=事好
事好干=事好幹
事迹=事蹟
事情=事情
事情干=事情幹
事情可干=事情可幹
事情好干=事情好幹
事都=事都
事都干=事都幹
事跡=事蹟
事關=事關
些干=些干
些干頭=些幹頭
些丑=些醜
些象=些像
亞裡=亞里
京沈=京瀋
佩环=珮環
佩饰=珮飾
佩飾=珮飾
佩環=珮環
佳肴=佳餚
佳裡=佳里
使心=使心
使心作幸=使心作倖
來干=來幹
來干旱=來乾旱
來干杯=來乾杯
來干枯=來乾枯
來干涉=來干涉
來干脆=來乾脆
來干淨=來乾淨
來干爽=來乾爽
來干裂=來乾裂
來干預=來干預
來干擾=來干擾
來范=來範
來象=來像
例范=例範
侏罗=侏儸
侏羅=侏儸
侖背=崙背
供制=供製
依托=依託
依准=依準
依赞=依贊
侥幸=儌倖
侥悻=僥倖
侧冲=側衝
兩扎=兩紮
兩只=兩隻
兩制=兩制
兩周=兩週
兩個=兩個
兩個中=兩個中
兩海=兩海
兩海裡=兩海里
兩裡=兩里
兩裡余=兩里餘
兩撇=兩撇
兩撇胡=兩撇鬍
其丑=其醜
其余=其餘
典范=典範
净几=淨几
净余=淨餘
凭吊=憑弔
凭借=憑藉
凭准=憑準
凯里=凱里
函义=涵義
函养=涵養
函复=函覆
函洞=涵洞
函容=涵容
函盖=涵蓋
函復=函覆
函意=涵意
函煦=涵煦
函義=涵義
函管=涵管
函蓄=涵蓄
函蓋=涵蓋
函數=函數
函養=涵養
函濡=涵濡
函蕴=涵蘊
函蘊=涵蘊
初斗=初鬥
初斗然=初陡然
初愈=初癒
刮大=刮大
刮大風=颳大風
刮风=颳風
刮胡=刮鬍
刮胡刀=刮鬍刀
刮胡須=刮鬍鬚
刮须=刮鬚
刮風=颳風
刮倒=颳倒
刮起=颳起
刮須=刮鬚
制丹=製丹
制为=製為
制片=製片
制出=製出
制件=製件
制冰=製冰
制成=製成
制衣=製衣
制作=製作
制冷=製冷
制材=製材
制纸=製紙
制剂=製劑
制图=製圖
制备=製備
制法=製法
制版=製版
制表=製表
制品=製品
制毒=製毒
制為=製為
制炼=製煉
制面=製麵
制面具=製面具
制革=製革
制盐=製鹽
制紙=製紙
制做=製做
制造=製造
制馅=製餡
制備=製備
制程=製程
制药=製藥
制煉=製煉
制圖=製圖
制播=製播
制醋=製醋
制鞋=製鞋
制劑=製劑
制器=製器
制糖=製糖
制餡=製餡
制藥=製藥
制鹽=製鹽
刺不=刺不
刺不准=刺不準
刺准=刺準
刻象=刻像
刻象征服=刻像征服
劾系=劾繫
卒发=捽髮
卒草=捽草
卒悉=窣窸
卒發=捽髮
卓約=卓約
卓約風姿=綽約風姿
单于=單于
卖奸=賣姦
卖姜=賣薑
卧游=臥遊
卷一=卷一
卷一卷=捲一捲
卷了=捲了
卷入=捲入
卷上=捲上
卷个=捲個
卷土=捲土
卷土重來=捲土重來
卷飞=捲飛
卷不=卷不
卷不起=捲不起
卷尺=捲尺
卷开=捲開
卷心=捲心
卷心菜=捲心菜
卷毛=捲毛
卷风=捲風
卷出=捲出
卷去=捲去
卷发=捲髮
卷伏=捲伏
卷动=捲動
卷向=捲向
卷回=捲回
卷好=捲好
卷成=捲成
卷扫=捲掃
卷曲=捲曲
卷至=捲至
卷舌=捲舌
卷衣=卷衣
卷衣袖=捲衣袖
卷伴=捲伴
卷住=捲住
卷来=捲來
卷纸=捲紙
卷走=捲走
卷身=捲身
卷过=捲過
卷來=捲來
卷兒=捲兒
卷到=捲到
卷卧=捲臥
卷帘=捲簾
卷往=捲往
卷拂=捲拂
卷拢=捲攏
卷臥=捲臥
卷进=捲進
卷绕=捲繞
卷轴=捲軸
卷须=卷鬚
卷風=捲風
卷飛=捲飛
卷個=捲個
卷射=捲射
卷浪=捲浪
卷涌=捲湧
卷烟=捲菸
卷紙=捲紙
卷起=捲起
卷逃=捲逃
卷動=捲動
卷得=捲得
卷掃=捲掃
卷旋=捲旋
卷着=捲著
卷袖=捲袖
卷袭=捲襲
卷款=捲款
卷湧=捲湧
卷發=捲髮
卷筒=捲筒
卷翘=捲翹
卷荡=捲蕩
卷菸=捲菸
卷著=捲著
卷軸=捲軸
卷進=捲進
卷開=捲開
卷須=捲鬚
卷滚=捲滾
卷煙=捲菸
卷碎=捲碎
卷缠=捲纏
卷罩=捲罩
卷落=卷落
卷落葉=捲落葉
卷過=捲過
卷圖=捲圖
卷滾=捲滾
卷缩=捲縮
卷舞=捲舞
卷裹=捲裹
卷鋪=卷鋪
卷鋪蓋=捲鋪蓋
卷蕩=捲蕩
卷鋼=捲鋼
卷縮=捲縮
卷繞=捲繞
卷翹=捲翹
卷攏=捲攏
卷簾=捲簾
卷纏=捲纏
卷襲=捲襲
参赞=參贊
取余=取餘
取舍=取捨
取准=取準
取谛=取締
取諦=取締
受人=受人
受人之托=受人之託
受托=受託
受雇=受僱
变征=變徵
变松=變鬆
周一=週一
周一岳=周一嶽
周二=週二
周三=週三
周五=週五
周六=週六
周历=週曆
周日=週日
周刊=週刊
周四=週四
周末=週末
周记=週記
周休=週休
周会=週會
周岁=週歲
周年=週年
周而=周而
周而復始=週而復始
周报=週報
周国=周國
周波=週波
周济=賙濟
周息=週息
周記=週記
周報=週報
周朝=周朝
周期=週期
周游=周遊
周数=週數
周會=週會
周歲=週歲
周數=週數
周潤=周潤
周潤發=周潤發
周遭=週遭
周歷=週曆
周濟=賙濟
周薪=週薪
呷干=呷乾
呼卷=呼捲
咀咽=咀嚥
咎征=咎徵
咏叹=詠歎
咕老=咕老
咕老肉=咕咾肉
囹围=囹圉
囹圍=囹圉
固定=固定
固定制=固定制
国历=國曆
国制=國製
图象=圖像
坤范=坤範
坦护=袒護
坦護=袒護
备注=備註
夜光=夜光
夜光表=夜光錶
夜游=夜遊
奇丑=奇醜
奇准=奇準
奇迹=奇蹟
奇跡=奇蹟
奋斗=奮鬥
姑负=辜負
姑負=辜負
姓名=姓名
姓名是於=姓名是于
姓於=姓于
姓钟=姓鍾
姓鐘=姓鍾
委托=委託
季咸=季咸
定干=定幹
定干吧=定幹吧
定制=定製
定准=定準
实干=實幹
实象=實像
尚余=尚餘
居裡=居里
岳立=嶽立
岳峙=嶽峙
帕特=帕特
帕特裡=帕特里
幸存=倖存
幸免=倖免
幸幸=倖幸
底裡=底里
店伙=店夥
店铺=店舖
店鋪=店舖
废后=廢后
延長=延長
弥弥=瀰瀰
弥散=瀰散
弥漫=瀰漫
弥蒙=瀰濛
弦乐=絃樂
弦线=絃線
弦索=絃索
弦琴=絃琴
弦歌=絃歌
弦管=絃管
弦樂=絃樂
弦線=絃線
录制=錄製
录象=錄像
彼彼=彼彼
彼彼皆是=比比皆是
往外=往外
往外斗=往外鬥
往外沖=往外衝
往後=往後
往後沖=往後衝
征了=徵了
征人=徵人
征入=徵入
征个=徵個
征友=徵友
征引=徵引
征文=徵文
征片=徵片
征去=徵去
征召=徵召
征用=徵用
征兆=徵兆
征地=徵地
征收=徵收
征兵=徵兵
征启=徵啟
征求=徵求
征状=徵狀
征纳=徵納
征诏=徵詔
征财=徵財
征取=徵取
征服=征服
征服兵=徵服兵
征狀=徵狀
征询=徵詢
征购=徵購
征信=徵信
征费=徵費
征個=徵個
征候=徵候
征納=徵納
征调=徵調
征財=徵財
征选=徵選
征啟=徵啟
征婚=徵婚
征得=徵得
征敛=徵斂
征逐=徵逐
征稅=徵稅
征税=徵稅
征詔=徵詔
征象=徵象
征費=徵費
征赋=徵賦
征集=徵集
征募=徵募
征意=征意
征意見=徵意見
征粮=徵糧
征聘=徵聘
征詢=徵詢
征管=徵管
征稿=徵稿
征調=徵調
征賦=徵賦
征缴=徵繳
征選=徵選
征斂=徵斂
征購=徵購
征糧=徵糧
征繳=徵繳
径自=逕自
径启=逕啟
径取=逕取
径庭=逕庭
径砸=逕砸
径寄=逕寄
径答=逕答
念一=念一
念一念=唸一唸
念一聲=唸一聲
念了=念了
念了一聲=唸了一聲
念下=念下
念下去=唸下去
念书=唸書
念好=唸好
念成=唸成
念佛=唸佛
念作=唸作
念完=唸完
念过=唸過
念來=念來
念來念去=唸來唸去
念到=唸到
念咒=唸咒
念念=唸唸
念法=唸法
念经=唸經
念点=唸點
念给=唸給
念诵=唸誦
念書=唸書
念起=念起
念起來=唸起來
念得=唸得
念着=唸著
念給=唸給
念著=唸著
念經=唸經
念過=唸過
念错=唸錯
念誦=唸誦
念錯=唸錯
念點=唸點
忽松=忽鬆
忽舍=忽舍
忽舍下=忽捨下
怕丑=怕醜
怖栗=怖慄
性征=性徵
性欲=性慾
或系=或系
或系之牛=或繫之牛
或松=或鬆
或采=或採
或咸=或鹹
所干=所幹
所扎=所紮
所布=所布
所布之=所佈之
所布的=所佈的
所余=所餘
所系=所繫
所見=所見
所見而雲=所見而云
所制=所制
所制約=所制約
所制造=所製造
所卷=所捲
所采=改採
所钟=所鍾
所雲=所云
所謂=所謂
所謂而雲=所謂而云
所譏=所譏
所譏而雲=所譏而云
所鐘=所鍾
承制=承製
披发=披髮
披肩發=披肩髮
披發=披髮
抬扛=抬摃
抱著=抱著
抵捂=抵捂
抵砺=砥礪
抵御=抵禦
抵牾=牴牾
抵触=牴觸
抵犢=抵犢
抵犢情深=舐犢情深
抵礪=砥礪
抵觸=牴觸
抹干=抹乾
抹台=抹檯
抹刹=抹煞
抹剎=抹煞
抺干=抺乾
抽干=抽乾
抽烟=抽菸
抽象=抽象
抽傭=抽佣
抽煙=抽菸
抽签=抽籤
抽簽=抽籤
抿灭=泯滅
抿滅=泯滅
拂须=拂鬚
拂須=拂鬚
拆斗=拆鬥
拆伙=拆夥
拆封=拆封
拆封後=拆封後
拈须=拈鬚
拈須=拈鬚
拉纤=拉縴
拉炼=拉鍊
拉面=拉麵
拉著=拉著
拉煉=拉鍊
拉裡=拉里
拉纖=拉縴
拋准=拋準
拌面=拌麵
拍出=拍出
拍出好戲=拍齣好戲
拍台=拍台
拍台拍凳=拍檯拍凳
拐子=枴子
拐仔=枴仔
拐杖=枴杖
拐棍=枴棍
拓本=搨本
拓朴=拓樸
拓朴學=拓樸學
拓碑=搨碑
拗別=拗彆
拗别=拗彆
拘系=拘繫
拙壮=茁壯
拙壯=茁壯
拚斗=拚鬥
拚命=拚命
拚命干=拚命幹
招魂=招魂
招魂幡=招魂旛
拢断=壟斷
拧干=擰乾
拧松=擰鬆
放松=放鬆
放姜=放薑
放著=放著
於小=於小
於小姐=于小姐
於氏=于氏
於右=於右
於右任=于右任
於先=於先
於先生=于先生
於成=於成
於成龍=于成龍
於於=于于
於思=於思
於思於思=于思于思
於美=於美
於美人=于美人
於飛=於飛
於飛之樂=于飛之樂
於嗟=于嗟
於謙=于謙
於歸=于歸
於歸去=於歸去
於歸回=於歸回
於歸來=於歸來
於歸家=於歸家
於歸途=於歸途
於歸程=於歸程
於歸路=於歸路
於歸還=於歸還
於闐=于闐
昆山=崑山
昆仑=崑崙
昆曲=崑曲
昆侖=崑崙
昆腔=崑腔
明国=明國
明范=明範
明朝=明朝
昏瞑=昏暝
易斗=易斗
易斗的=易鬥的
易松=易鬆
服赝=服膺
服贗=服膺
杯干=杯乾
杯白=杯白
杯白干=杯白乾
杯面=杯麵
杰伦=杰倫
東升=東昇
東西後=東西後
東沖=東衝
東周=東周
東岳=東嶽
東東=東東
東東裡面=東東裡面
東涂=東塗
東游=東遊
東湧=東涌
東裡=東里
松一=松一
松一下=鬆一下
松一口氣=鬆一口氣
松一些=鬆一些
松一松=鬆一鬆
松了=鬆了
松了松=鬆了鬆
松下=松下
松下一口=鬆下一口
松下了=鬆下了
松下來=鬆下來
松口=鬆口
松土=鬆土
松干=松幹
松不=松不
松不松=鬆不鬆
松不開=鬆不開
松不緊=鬆不緊
松化=鬆化
松开=鬆開
松手=鬆手
松毛=松毛
松毛松翼=鬆毛鬆翼
松气=鬆氣
松出=松出
松出一=鬆出一
松出口=鬆出口
松去=鬆去
松甩=鬆甩
松动=鬆動
松弛=鬆弛
松驰=鬆弛
松劲=鬆勁
松快=鬆快
松肘=鬆肘
松闲=鬆閒
松些=鬆些
松放=鬆放
松松=鬆鬆
松油=松油
松油門=鬆油門
松油管=鬆油管
松泛=鬆泛
松泥=鬆泥
松线=鬆線
松肩=鬆肩
松软=鬆軟
松齿=鬆齒
松勁=鬆勁
松垮=鬆垮
松柔=鬆柔
松绑=鬆綁
松饼=鬆餅
松宽=鬆寬
松晃=鬆晃
松氣=鬆氣
松浮=鬆浮
松紧=鬆緊
松脆=鬆脆
松起=鬆起
松骨=鬆骨
松動=鬆動
松得=松得
松得多=鬆得多
松掉=鬆掉
松球=松毬
松绳=鬆繩
松脫=鬆脫
松脱=鬆脫
松蛋=鬆蛋
松軟=鬆軟
松通=鬆通
松散=鬆散
松筋=鬆筋
松缓=鬆緩
松開=鬆開
松閒=鬆閒
松塌=鬆塌
松綁=鬆綁
松腰=鬆腰
松解=鬆解
松馳=鬆弛
松緊=鬆緊
松餅=鬆餅
松寬=鬆寬
松線=鬆線
松緩=鬆緩
松齒=鬆齒
松懈=鬆懈
松糕=鬆糕
松繩=鬆繩
板剉=板銼
极干=極乾
极极=亟亟
极准=極準
极象=極像
构陷=搆陷
果干=果乾
果系=果係
果系統=果系統
枝干=枝幹
枝芽=枝枒
枢钮=樞紐
欧游=歐遊
武斗=武鬥
殴斗=毆鬥
河落=河落
河落海干=河落海乾
油面=油麵
治疔=治療
治愈=治癒
沾汙=玷汙
沾污=玷汙
沾辱=玷辱
沿著=沿著
泄欲=洩慾
法国=法國
泛游=泛遊
泛滥=氾濫
泛濫=氾濫
泡制=泡製
泡面=泡麵
波裡=波里
泥涂=泥塗
泥象=泥像
注:=註:
注：=註：
注上=註上
注冊=註冊
注册=註冊
注失=註失
注生=注生
注生娘娘=註生娘娘
注记=註記
注译=註譯
注明=註明
注标=註標
注記=註記
注疏=註疏
注脚=註腳
注释=註釋
注销=註銷
注腳=註腳
注解=註解
注標=註標
注銷=註銷
注譯=註譯
注釋=註釋
泪干=淚乾
泱郁=泱鬱
炒干=炒乾
炒面=炒麵
爭斗=爭鬥
物志=物誌
物欲=物慾
环佩=環珮
环游=環遊
画象=畫像
畅游=暢遊
的丑=的醜
的丑相=的醜相
的亮=的亮
的亮發=的亮髮
的發=的發
的發式=的髮式
的發型=的髮型
盲干=盲幹
盲冲=盲衝
盲沖=盲衝
直干=直幹
直发=直髮
直冲=直衝
直沖=直衝
直卷=直捲
直發=直髮
直發毛=直發毛
直發汗=直發汗
直發抖=直發抖
直發問=直發問
知丑=知醜
秃发=禿髮
空余=空餘
空蒙=空濛
细致=細緻
罔罔=惘惘
罔然=惘然
罗里=羅里
罗音=囉音
罗哩=囉哩
罗唆=囉唆
罗苏=囉囌
罗难=罹難
罗啰=囉囉
罗嗦=囉嗦
者系=者係
者雲=者云
股栗=股慄
肢体=肢體
肯干=肯幹
肯干啊=肯幹啊
肴撰=餚饌
肺脏=肺臟
肺髒=肺臟
肾脏=腎臟
臥游=臥遊
舍下=舍下
舍下他=捨下他
舍下她=捨下她
舍下你=捨下你
舍下我=捨下我
舍己=捨己
舍不=舍不
舍不得=捨不得
舍出=捨出
舍去=捨去
舍本=捨本
舍生=捨生
舍死=捨死
舍弃=捨棄
舍我=舍我
舍我其誰=捨我其誰
舍身=捨身
舍車=舍車
舍車保帥=捨車保帥
舍命=捨命
舍近=捨近
舍得=捨得
舍棄=捨棄
舍短=捨短
舍舊=舍舊
舍舊迎新=捨舊迎新
节余=節餘
节欲=節慾
花卷=花捲
花發=花發
花發老=花髮老
花雕=花彫
虎斗=虎鬥
虎咽=虎嚥
虎须=虎鬚
虎須=虎鬚
虯須=虯鬚
补注=補註
表厂=錶廠
表壳=錶殼
表店=錶店
表征=表徵
表带=錶帶
表炼=錶鏈
表范=表範
表帶=錶帶
表殼=錶殼
表链=錶鏈
表煉=錶鏈
表演=表演
表演欲=表演慾
表廠=錶廠
表鏈=錶鏈
规范=規範
规模=規模
觅准=覓準
诗余=詩餘
诚朴=誠樸
诚征=誠徵
该象=該像
详征=詳徵
详注=詳註
质朴=質樸
贪欲=貪慾
购并=購併
转托=轉託
转寰=轉圜
轮回=輪迴
轮奸=輪姦
软发=軟髮
迎斗=迎鬥
还象=還像
这里=這裡
远扬=遠颺
远游=遠遊
连斗=連鬥
连发=連發
连抉=連袂
连系=連繫
连卷=連卷
连杰=連杰
连络=聯絡
邻里=鄰里
采办=採辦
采水=採水
采计=採計
采认=採認
采写=採寫
采生=採生
采用=採用
采石=採石
采买=採買
采伐=採伐
采光=採光
采收=採收
采血=採血
采行=採行
采访=採訪
采卵=採卵
采纳=採納
采证=採證
采供=採供
采取=採取
采录=採錄
采择=採擇
采油=採油
采矿=採礦
采花=採花
采芹=採芹
采补=採補
采购=採購
采金=採金
采信=採信
采拾=採拾
采挖=採挖
采树=採樹
采种=採種
采計=採計
采風=采風
采風力=採風力
采食=採食
采饵=採餌
采样=採樣
采桑=採桑
采珠=採珠
采粉=採粉
采納=採納
采茶=採茶
采草=採草
采选=採選
采验=採驗
采掘=採掘
采梅=採梅
采检=採檢
采猎=採獵
采硫=採硫
采获=採獲
采訪=採訪
采编=採編
采药=採藥
采買=採買
采集=採集
采煤=採煤
采莲=採蓮
采補=採補
采摘=採摘
采摭=採摭
采種=採種
采精=採精
采蜜=採蜜
采認=採認
采餌=採餌
采寫=採寫
采撷=採擷
采樣=採樣
采稿=採稿
采編=採編
采蓮=採蓮
采擇=採擇
采樵=採樵
采樹=採樹
采辦=採辦
采選=採選
采錄=採錄
采檢=採檢
采獲=採獲
采薇=採薇
采購=採購
采擷=採擷
采獵=採獵
采藥=採藥
采證=採證
采礦=採礦
采驗=採驗
金仑=金崙
金侖=金崙
金国=金國
金杯=金盃
金象=金象
金象獎=金像獎
金橘=金桔
钓游=釣遊
钗环=釵鐶
長台=長檯
長得=長得
長得丑=長得醜
長發=長發
長發布=長發布
長發如飛=長髮如飛
長發式=長髮式
長發色=長髮色
長發夾=長髮夾
長發束=長髮束
長發邨=長發邨
長發卷=長髮捲
長發妻=長髮妻
長發姐=長髮姐
長發冠=長髮冠
長發根=長髮根
長發梳=長髮梳
長發帶=長髮帶
長發梢=長髮梢
長發絲=長髮絲
長發辮=長髮辮
長象=長像
長須=長鬚
長籲=長吁
門斗=門鬥
門坎=門檻
門梁=門樑
阿松=阿松
阿咸=阿咸
阿腴=阿諛
阿裡=阿里
陀手=舵手
陀表=陀錶
附注=附註
陈国=陳國
青笞=青苔
青棵=青稞
非涂=非涂
非涂不可=非塗不可
非常=非常
非常不准=非常不準
非常丑=非常醜
非常准=非常準
非常象=非常像
非象=非像
非象征服=非像征服
顶凶=頂兇
驻扎=駐紮
鱼干=魚乾
鱼松=魚鬆
亮丑=亮醜
亲征=親征
侵并=侵併
侵並=侵併
侵范=侵範
便斗=便斗
便吃=便吃
便吃干=便吃乾
便松=便鬆
便象=便像
俊丑=俊醜
保不=保不
保不准=保不準
保准=保準
信托=信託
信而=信而
信而有征=信而有徵
信缄=信箋
信緘=信箋
俭朴=儉樸
养发=養髮
剃发=剃髮
剃须=剃鬚
剃發=剃髮
剃須=剃鬚
則采=則採
則象=則像
則象征服=則像征服
則象征戰=則像征戰
剉刀=銼刀
剉工=銼工
剉平=銼平
剉冰=銼冰
削发=削髮
削發=削髮
剌刀=刺刀
前冲=前衝
前沖=前衝
前僕=前僕
前僕後=前仆後
勁斗=勁鬥
勇斗=勇鬥
南冲=南衝
南回=南迴
南沖=南衝
南岳=南嶽
南征=南征
南游=南遊
南裡=南里
卻象=卻像
厘出=釐出
厘正=釐正
厘米=釐米
厘定=釐定
厘訂=釐訂
厘清=釐清
咨议=諮議
咨询=諮詢
咨诹=諮諏
咨商=諮商
咨谋=諮謀
咨詢=諮詢
咨諏=諮諏
咨謀=諮謀
咨議=諮議
咬字=咬字
咬字不准=咬字不準
咬姜=咬姜
咬姜呷醋=咬薑呷醋
咸土=鹹土
咸丰=咸豐
咸五=咸五
咸水=鹹水
咸池=咸池
咸肉=鹹肉
咸阳=咸陽
咸味=鹹味
咸和=咸和
咸宜=咸宜
咸的=鹹的
咸咸=鹹鹹
咸度=鹹度
咸海=鹹海
咸得=鹹得
咸淡=鹹淡
咸蛋=鹹蛋
咸魚=鹹魚
咸鹵=鹹鹵
咸湖=鹹湖
咸湯=鹹湯
咸菜=鹹菜
咸豬=鹹豬
咸鴨=鹹鴨
咸濕=鹹濕
咸類=鹹類
咽一=咽一
咽一口=嚥一口
咽了=嚥了
咽入=嚥入
咽下=嚥下
咽口=咽口
咽口水=嚥口水
咽不=咽不
咽不了=嚥不了
咽不下=嚥不下
咽气=嚥氣
咽回=嚥回
咽住=嚥住
咽苦=咽苦
咽苦吞甘=嚥苦吞甘
咽食=嚥食
咽氣=嚥氣
咽得=咽得
咽得下=嚥得下
咽着=嚥著
咽唾=嚥唾
咽著=嚥著
咽嚼=嚥嚼
哀吊=哀弔
品汇=品彙
品尝=品嚐
品匯=品彙
品嘗=品嚐
哆羅=哆羅
哆羅哆嗦=哆囉哆嗦
哈罗=哈囉
哈裡=哈里
哈羅=哈囉
响当=響噹
哗的=譁的
垂发=垂髮
垂范=垂範
垂發=垂髮
型状=形狀
型狀=形狀
型范=型範
垦辟=墾闢
复习=複習
复亡=覆亡
复书=覆書
复文=覆文
复方=複方
复比=複比
复写=複寫
复句=複句
复叶=複葉
复本=複本
复灭=覆滅
复电=覆電
复目=複目
复决=複決
复列=複列
复印=複印
复式=複式
复杂=複雜
复次=複次
复舟=覆舟
复色=複色
复利=複利
复没=覆沒
复诊=複診
复词=複詞
复函=覆函
复制=複製
复变=複變
复命=覆命
复姓=複姓
复审=覆審
复线=複線
复试=複試
复败=覆敗
复信=覆信
复复=覆覆
复查=複查
复测=複測
复种=複種
复述=複述
复音=複音
复核=覆核
复苏=復甦
复选=複選
复钱=複錢
复阅=複閱
复巢=覆巢
复检=複檢
复盖=覆蓋
复眼=複眼
复叠=覆疊
复数=複數
复韵=複韻
复赛=複賽
复壁=複壁
复辙=覆轍
奏折=奏摺
奕棋=弈棋
奖杯=獎盃
姜片=薑片
姜丝=薑絲
姜末=薑末
姜汁=薑汁
姜汤=薑湯
姜老=姜老
姜老辣=薑老辣
姜油=薑油
姜花=薑花
姜是=薑是
姜是老=薑是老
姜饼=薑餅
姜茶=薑茶
姜黄=薑黃
姜就=姜就
姜就是老=薑就是老
姜湯=薑湯
姜絲=薑絲
姜黃=薑黃
姜愈=姜愈
姜愈老=薑愈老
姜葱=薑蔥
姜餅=薑餅
姜蔥=薑蔥
姜醋=薑醋
姜糖=薑糖
姜還=姜還
姜還是老=薑還是老
姣洁=皎潔
姣潔=皎潔
客游=客遊
宣布=宣佈
宣傳=宣傳
宣傳周=宣傳週
宣赞=宣贊
室內=室內
宦游=宦遊
封後=封后
屋內=屋內
屋梁=屋樑
屍位=尸位
屍祿=尸祿
峇厘=峇里
峇裡=峇里
峇釐=峇里
帝国=帝國
帝後=帝后
带发=帶髮
带征=帶徵
幽郁=幽鬱
很干=很乾
很丑=很醜
很松=很鬆
很咸=很鹹
很准=很準
很象=很像
後土=后土
後奸=後姦
後妃=后妃
後制=後製
後冠=后冠
後羿=后羿
後梁=後樑
後象=後像
後象征服=後像征服
後稷=后稷
怎幺=怎麼
怎麼干=怎麼幹
怎麼斗=怎麼鬥
怒氣=怒氣
怒氣沖沖=怒氣衝衝
怒發=怒發
怒發沖天=怒髮衝天
怒發沖冠=怒髮衝冠
思念=思念
急冲=急衝
急沖=急衝
急卷=急捲
急征=急徵
恂栗=恂慄
恢複=恢復
恰象=恰像
战斗=戰鬥
战栗=顫慄
扁剉=扁銼
拜占=拜佔
拜托=拜託
拜佔庭=拜占庭
拭干=拭乾
拮據=拮据
拼一=拼一
拼一拼=拚一拚
拼力=拚力
拼上=拼上
拼上一拼=拚上一拚
拼个=拚個
拼斗=拚鬥
拼生=拚生
拼杀=拚殺
拼死=拚死
拼劲=拚勁
拼命=拚命
拼经=拚經
拼舍=拚捨
拼勁=拚勁
拼政=拚政
拼活=拚活
拼個=拚個
拼得=拼得
拼得過=拚得過
拼殺=拚殺
拼搏=拚搏
拼經=拚經
挂历=掛曆
挂彩=掛綵
挂碍=罣礙
指數=指數
挑了=挑了
挑了只=挑了隻
挑大=挑大
挑大梁=挑大樑
挑斗=挑鬥
挖松=挖鬆
挞虏=韃虜
挡御=擋禦
挣松=掙鬆
挥杆=揮杆
挥卷=揮捲
故布=故佈
故裡=故里
施舍=施捨
既准=既准
既准且=既準且
既象=既像
星历=星曆
星辰=星辰
星辰表=星辰錶
星歷=星曆
星歷代=星歷代
星歷史=星歷史
星歷任=星歷任
星歷經=星歷經
星歷盡=星歷盡
星歷險=星歷險
映象=映像
春卷=春捲
春游=春遊
是干=是干
是干的=是乾的
是干脆=是乾脆
是丑=是醜
是白=是白
是白干=是白幹
显象=顯像
枯干=枯幹
架梁=架樑
某只=某隻
染发=染髮
染發=染髮
柔发=柔髮
柔發=柔髮
柜台=櫃檯
柱梁=柱樑
标志=標誌
标杆=標竿
标注=標註
标致=標緻
标准=標準
标签=標籤
栋梁=棟樑
栏杆=欄杆
树干=樹幹
洗手=洗手
洗手不干=洗手不幹
洗发=洗髮
洗發=洗髮
洗發動機=洗發動機
洩沓=泄沓
洩洩=泄泄
洩欲=洩慾
洩殖=泄殖
洪范=洪範
洲杯=洲盃
洲游=洲遊
活干=活幹
活象=活像
流干=流乾
流卷=流捲
流風=流風
流風余=流風餘
浇制=澆製
测准=測準
浑函=渾涵
浓发=濃髮
浓纤=穠纖
炮制=炮製
炸毀=炸燬
炸毁=炸燬
点松=點鬆
点象=點像
為范=為範
為准=為準
炼子=鍊子
炼制=煉製
炼锁=鍊鎖
牲干=牲干
牲干下=牲幹下
牵系=牽繫
狠、=狠、
狠、准=狠、準
狠又=狠又
狠又准=狠又準
狠干=狠幹
狠斗=狠鬥
狠且=狠且
狠且准=狠且準
独斗=獨鬥
独钟=獨鍾
独游=獨遊
独辟=獨闢
玲胧=玲瓏
玲朧=玲瓏
玻裡=玻裡
玻裡尼西=玻里尼西
珐琅=琺瑯
甚丑=甚醜
甚松=甚鬆
甚准=甚準
甚麼=甚麼
甚麼都干=甚麼都幹
癸丑=癸丑
皆准=皆準
皆雲=皆云
皇历=皇曆
皇後=皇后
皇歷=皇曆
盆吊=盆弔
盈余=盈餘
相干=相干
相斗=相鬥
相奸=相姦
相并=相併
相克=相剋
相形=相形
相形見拙=相形見絀
相並=相併
相拼=相拚
相准=相準
相象=相像
相當=相當
相當准=相當準
相關=相關
眈误=耽誤
眈誤=耽誤
看不=看不
看不准=看不準
看出=看出
看出電影=看齣電影
看准=看準
看著=看著
砌并=砌併
砌並=砌併
砍准=砍準
研制=研製
秋千=鞦韆
秋不=秋不
秋不干=秋不乾
秋台=秋颱
秋游=秋遊
种谷=種穀
秒表=秒錶
穿著=穿著
竽头=芋頭
竽頭=芋頭
紀念=紀念
紀念周=紀念週
紀歷=紀曆
約斗=約鬥
約雇=約僱
紅須=紅須
紅須綠眼=紅鬚綠眼
紅簽=紅籤
紆回=紆迴
紆余=紆餘
紆郁=紆鬱
紈絝=紈袴
紈絝子弟=紈褲子弟
绑扎=綁紮
结扎=結紮
结发=結髮
结伙=結夥
结余=結餘
结彩=結綵
绕梁=繞樑
绘制=繪製
绞干=絞乾
美丑=美醜
美制=美製
美制定=美制定
美制訂=美制訂
美国=美國
美或=美或
美或丑=美或醜
美與=美與
美與丑=美與醜
耐心=耐心
耐心細緻=耐心細緻
胃脏=胃臟
胃髒=胃臟
胄子=胄子
胄裔=胄裔
胆战=膽顫
背系=背繫
背影=背影
背影後=背影後
胜余=勝餘
胡子=鬍子
胡干=胡幹
胡须=鬍鬚
胡涂=胡塗
胡梢=鬍梢
胡雪=胡雪
胡雪岩=胡雪巖
胡渣=鬍渣
胡須=鬍鬚
胡裡=胡裡
胡裡胡涂=糊裡糊塗
胡碴=胡碴
胡碴子=鬍碴子
胡髯=鬍髯
胡髭=鬍髭
胡鬓=鬍鬢
胡鬢=鬍鬢
脉冲=脈衝
致密=緻密
苛征=苛徵
若干=若干
若象=若像
苦干=苦幹
苦斗=苦鬥
苦瓜=苦瓜
苦瓜干=苦瓜乾
英九=英九
英寸=英吋
英尺=英呎
英国=英國
英裡=英里
范不=范不
范不著=範不著
范文=範文
范本=範本
范式=範式
范行=範行
范围=範圍
范例=範例
范险=範險
范圍=範圍
范畴=範疇
范險=範險
范疇=範疇
茅芦=茅廬
茅蘆=茅廬
茎干=莖幹
衫畢=衫畢
衫畢挺=衫筆挺
要干=要干
要干了=要乾了
要干什麼=要幹什麼
要干杯=要乾杯
要干嘛=要幹嘛
要丑=要丑
要丑上=要醜上
要斗=要鬥
要冲=要衝
要象=要像
要衝水=要沖水
要衝涼=要沖涼
要衝廁=要沖廁
訂制=訂製
計准=計準
計劃=計畫
诬蔑=誣衊
语汇=語彙
误冲=誤衝
诱奸=誘姦
诱欲=誘慾
说签=說籤
贴志=貼誌
贵干=貴幹
赵国=趙國
軌范=軌範
轸域=畛域
轻台=輕颱
轻松=輕鬆
轻挑=輕佻
轻篾=輕蔑
迥廊=迴廊
迥避=迴避
迨尽=殆盡
迨盡=殆盡
郁于=鬱於
郁火=鬱火
郁纡=鬱紆
郁血=鬱血
郁闭=鬱閉
郁抑=鬱抑
郁沈=鬱沈
郁沉=鬱沉
郁邑=鬱邑
郁闷=鬱悶
郁卒=鬱卒
郁於=鬱於
郁林=鬱林
郁泱=鬱泱
郁金=郁金
郁金香=鬱金香
郁垒=鬱壘
郁律=鬱律
郁怒=鬱怒
郁紆=鬱紆
郁结=鬱結
郁郁=鬱鬱
郁悒=鬱悒
郁挹=鬱挹
郁热=鬱熱
郁症=鬱症
郁积=鬱積
郁閉=鬱閉
郁堙=鬱堙
郁悶=鬱悶
郁愤=鬱憤
郁痛=鬱痛
郁結=鬱結
郁黑=鬱黑
郁塞=鬱塞
郁暗=鬱暗
郁蓊=鬱蓊
郁憤=鬱憤
郁熱=鬱熱
郁懊=鬱懊
郁積=鬱積
郁燠=鬱燠
郁壘=鬱壘
郁巍=鬱巍
郊游=郊遊
郎铛=啷鐺
郎鐺=啷鐺
重托=重託
重复=重複
重涂=重塗
重復=重複
重游=重遊
重簷=重檐
钟山=鍾山
钟不=鍾不
钟表=鐘錶
钟爱=鍾愛
钟情=鍾情
钟馗=鍾馗
钟意=鍾意
钢制=鋼製
钢拐=鋼枴
钢梁=鋼樑
钦崎=嶔崎
闺范=閨範
闽国=閩國
限制=限制
面厂=麵廠
面丑=面醜
面白=面白
面白無須=面白無鬚
面价=麵價
面团=麵糰
面汤=麵湯
面灰=麵灰
面杖=麵杖
面龟=麵龜
面店=麵店
面店鋪=麵店舖
面疙=面疙
面疙瘩=麵疙瘩
面线=麵線
面食=麵食
面食面=麵食麵
面饺=麵餃
面饼=麵餅
面粉=麵粉
面茶=麵茶
面馆=麵館
面朝=面朝
面湯=麵湯
面筋=麵筋
面摊=麵攤
面碗=麵碗
面馍=麵饃
面團=麵糰
面餃=麵餃
面餅=麵餅
面價=麵價
面價值=面價值
面廠=麵廠
面糊=麵糊
面線=麵線
面館=麵館
面龜=麵龜
面饃=麵饃
面攤=麵攤
面攤牌=面攤牌
面攤開=面攤開
韋後=韋后
韋席=韋蓆
音不=音不
音不准=音不準
音准=音準
音象=音像
頁面=頁面
頁簽=頁籤
项炼=項鍊
须子=鬚子
须毛=鬚毛
须发=鬚髮
须求=需求
须采=須採
须眉=鬚眉
须须=鬚鬚
须叟=須臾
须根=鬚根
须髯=鬚髯
须鲸=鬚鯨
须鬓=鬚鬢
風土=風土
風土志=風土誌
風干=風乾
風刮=風颳
風卷=風捲
風卷殘雲=風捲殘雲
風物=風物
風物志=風物誌
風姿=風姿
風姿卓約=風姿綽約
風范=風範
飛升=飛昇
飛卷=飛捲
食面=食麵
食欲=食慾
饼干=餅乾
首只=首隻
首周=首週
首發=首發
香烟=香菸
香港=香港
香港游=香港遊
香煙=香菸
修胡=修胡
修胡刀=修鬍刀
修浚=修濬
俯冲=俯衝
俯沖=俯衝
俱象=俱像
個象=個像
倍余=倍餘
們干=們幹
們干女兒=們干女兒
們干兒子=們干兒子
們干涉=們干涉
們干爹=們干爹
們干脆=們干脆
們干淨=們干淨
們干預=們干預
們干擾=們干擾
倒卷=倒捲
倒象=倒像
倒僕=倒仆
倒黴=倒霉
倛丑=倛醜
借口=藉口
借以=藉以
借托=借託
借机=藉機
借词=藉詞
借故=藉故
借着=藉著
借著=藉著
借詞=藉詞
借機=藉機
倦游=倦遊
值得=值得
值得一干=值得一幹
值得干=值得幹
倾刻=頃刻
倾复=傾覆
兼并=兼併
兼並=兼併
凄息=棲息
凄戚=悽慼
准！=準！
准儿=準兒
准女=准女
准女婿=準女婿
准不=准不
准不及=準不及
准不可=準不可
准不成=準不成
准不是=準不是
准不准備=準不準備
准不准確=準不準確
准不能=準不能
准不得=準不得
准不會=準不會
准且=准且
准且勁=準且勁
准以=准以
准以為=準以為
准叫=準叫
准叫你=準叫你
准可=準可
准司=准司
准司法=準司法
准外=准外
准外父=準外父
准外母=準外母
准头=準頭
准平=准平
准平原=準平原
准会=準會
准决=準決
准则=準則
准吃=准吃
准吃虧=準吃虧
准成=準成
准有=準有
准死=準死
准而=准而
准而快=準而快
准把=準把
准时=準時
准決=準決
准決斗=准決鬥
准決賽=準決賽
准沒=準沒
准没=準沒
准些=準些
准兒=準兒
准到=準到
准备=準備
准定=準定
准拟=準擬
准极=準極
准爸=准爸
准爸爸=準爸爸
准直=準直
准知=準知
准线=準線
准话=準話
准則=準則
准度=準度
准星=準星
准是=準是
准点=準點
准要=準要
准倒=准倒
准倒黴=準倒霉
准准=準準
准時=準時
准能=準能
准够=準夠
准夠=準夠
准得=準得
准据=準據
准绳=準繩
准被=準被
准備=準備
准博=准博
准博士=準博士
准确=準確
准媽=准媽
准媽媽=準媽媽
准新=准新
准新郎=準新郎
准新娘=準新娘
准會=準會
准極=準極
准話=準話
准確=準確
准線=準線
准噶=准噶
准噶爾=準噶爾
准據=準據
准錯=准錯
准錯不了=準錯不了
准頭=準頭
准擬=準擬
准點=準點
准繩=準繩
准譜=准譜
准譜兒=準譜兒
凉面=涼麵
凉席=涼蓆
剧斗=劇鬥
匪干=匪幹
員干=員干
員干將=員幹將
哥裡=哥里
哪象=哪像
哪裡=哪裡
哲雲=哲云
唁吊=唁弔
唇干=唇乾
唇燥=唇燥
唇燥舌干=唇燥舌乾
唐国=唐國
唐朝=唐朝
唠叼=嘮叨
圆椎=圓錐
埃裡=埃裡
埃裡溫=埃里溫
埔裡=埔里
壶范=壺範
夏历=夏曆
夏国=夏國
夏朝=夏朝
夏歷=夏曆
娉亭=娉婷
宴游=宴遊
家丑=家醜
家伙=傢伙
家私=傢俬
家俱=傢俱
家裡=家裡
宸游=宸遊
容范=容範
宽松=寬鬆
宽范=寬範
射不=射不
射不准=射不準
射准=射準
射雕=射鵰
展布=展佈
峰回=峰迴
島煉=島鍊
師云=師云
師云而雲=師云而云
師范=師範
席子=蓆子
席卷=席捲
座象=座像
弱干=弱幹
徑自=逕自
徑取=逕取
徑庭=逕庭
徑砸=逕砸
徑啟=逕啟
徑寄=逕寄
徑答=逕答
徒托=徒託
徒峭=陡峭
恥奪=褫奪
恭逢=躬逢
息影=息影
息影後=息影後
恳托=懇託
恶心=噁心
恶斗=惡鬥
悒郁=悒鬱
悚栗=悚慄
扇开=搧開
扇风=搧風
扇动=搧動
扇耳=扇耳
扇耳光=搧耳光
扇風=搧風
扇動=搧動
扇開=搧開
拿不=拿不
拿不准=拿不準
拿奸=拿姦
拿准=拿準
拿破=拿破
拿破侖=拿破崙
挛生=孿生
振荡=振盪
振蕩=振盪
挹郁=挹鬱
挺而=鋌而
挺准=挺準
挺象=挺像
挽发=挽髮
挽词=輓詞
挽诗=輓詩
挽近=輓近
挽發=挽髮
挽联=輓聯
挽詞=輓詞
挽詩=輓詩
挽歌=輓歌
挽聯=輓聯
捂不=捂不
捂不住=摀不住
捂住=摀住
捂受=捂受
捂蓋=摀蓋
捆扎=捆紮
捉不=捉不
捉不准=捉不準
捉只=捉隻
捉奸=捉姦
捉狭=促狹
捉准=捉準
捉狹=促狹
捋虎=捋虎
捋虎須=捋虎鬚
捋胡=捋鬍
捋须=捋鬚
捋須=捋鬚
捍拒=扞拒
捍格=扞格
捍御=捍禦
捏不=捏不
捏不准=捏不準
捏制=捏製
捏准=捏準
换只=換隻
换签=換籤
效尤=傚尤
效法=傚法
敌国=敵國
料不=料不
料不准=料不準
料准=料準
旁征=旁征
旁征博引=旁徵博引
旁注=旁註
旁徨=徬徨
旁惶=徬徨
旅游=旅遊
時干=時干
時干下=時幹下
時憲=時憲
時憲歷=時憲曆
晉升=晉陞
晋升=晉陞
晋国=晉國
晋朝=晉朝
晒干=曬乾
晒谷=曬穀
書台=書檯
書童=書僮
書簽=書籤
栓住=拴住
栗人=慄人
栗声=慄聲
栗冽=慄冽
栗栗=慄慄
栗惊=慄驚
栗然=慄然
栗聲=慄聲
栗驚=慄驚
校准=校準
株象=株像
样干=樣幹
样范=樣範
核复=核覆
核復=核覆
根烟=根菸
根煙=根菸
格斗=格鬥
格范=格範
格裡=格里
格裡歷=格里曆
桅桿=桅杆
案幾=案几
桌面=桌面
桑干=桑乾
桥梁=橋樑
梳发=梳髮
梳發=梳髮
殊勳=殊勛
残干=殘幹
残余=殘餘
残肴=殘餚
殷勤=慇勤
氣一=氣一
氣一沖=氣一衝
氣郁=氣鬱
氣慨=氣概
氣象=氣象
氤郁=氤鬱
泰历=泰曆
泰国=泰國
泰歷=泰曆
浆划=槳劃
浚深=濬深
浪一=浪一
浪一沖=浪一衝
浪又=浪又
浪又沖=浪又衝
浪冲=浪衝
浪沖=浪衝
浪卷=浪捲
浪琴=浪琴
浪琴表=浪琴錶
浮松=浮鬆
浮签=浮籤
浮簽=浮籤
海干=海乾
海函=海涵
浸制=浸製
涂了=塗了
涂上=塗上
涂去=塗去
涂布=塗布
涂在=塗在
涂地=塗地
涂好=塗好
涂成=塗成
涂有=塗有
涂色=塗色
涂改=塗改
涂来=涂來
涂來涂去=塗來塗去
涂到=塗到
涂制=塗製
涂抹=塗抹
涂油=塗油
涂炭=塗炭
涂料=塗料
涂涂=塗塗
涂消=塗消
涂粉=塗粉
涂脂=塗脂
涂得=塗得
涂掉=塗掉
涂著=塗著
涂黑=塗黑
涂裝=塗裝
涂過=塗過
涂飾=塗飾
涂滿=塗滿
涂漆=塗漆
涂說=塗說
涂寫=塗寫
涂層=塗層
涂潭=塗潭
涂膠=塗膠
涂銷=塗銷
涂鴉=塗鴉
涂鴨=塗鴨
涂竄=塗竄
涂覆=塗覆
涂藥=塗藥
涂蠟=塗蠟
涅盘=涅槃
涅盤=涅槃
消費=消費
消費欲=消費慾
涌卷=湧捲
润发=潤髮
烏丘=烏坵
烏發=烏髮
烏裡=烏里
烏龍=烏龍
烏龍面=烏龍麵
烘干=烘乾
烘制=烘製
烘熏=烘燻
烟斗=菸斗
烟头=菸頭
烟民=菸民
烟灰=菸灰
烟没=湮沒
烟卷=菸卷
烟枪=菸槍
烟客=菸客
烟草=菸草
烟酒=菸酒
烟鬼=菸鬼
烟商=菸商
烟龄=菸齡
烟熏=煙燻
烟瘾=菸癮
烤干=烤乾
烦郁=煩鬱
烧干=燒乾
烧制=燒製
烧毁=燒燬
烩干=燴乾
烩制=燴製
烫发=燙髮
烫面=燙麵
烬余=燼餘
爱欲=愛慾
特制=特製
特征=特徵
狼借=狼藉
留发=留髮
留發=留髮
畛怀=軫懷
畛懷=軫懷
畝余=畝餘
疲困=疲睏
疾冲=疾衝
疾沖=疾衝
疾卷=疾捲
病入=病入
病入膏盲=病入膏肓
病征=病徵
病愈=病癒
病難=病難
病難愈=病難癒
症结=癥結
症結=癥結
痉孪=痙攣
皱折=皺摺
盍盍=溘溘
盍逝=溘逝
盍然=溘然
盍谢=溘謝
盍謝=溘謝
盐余=鹽餘
盐卤=鹽滷
监制=監製
真丑=真醜
真凶=真兇
真知=真知
真知卓見=真知灼見
真准=真準
真缔=真諦
真象=真像
真象科=真象科
真締=真諦
眩耀=炫耀
砰当=砰噹
砰當=砰噹
破壞=破壞
破壞欲=破壞慾
神只=神祇
神佑=神祐
神准=神準
神祗=神祇
神迹=神蹟
神游=神遊
神象=神像
神經=神經
神經干=神經幹
神跡=神蹟
秘制=秘製
租贷=租賃
租貸=租賃
秤斗=秤斗
秤鎚=秤錘
秦国=秦國
秦朝=秦朝
积谷=積穀
积郁=積鬱
积淀=積澱
竞斗=競鬥
笆蕉=芭蕉
笋干=筍乾
笋况=荀況
笑讷=笑納
笑容=笑容
笑容可鞠=笑容可掬
笑訥=笑納
笑魇=笑靨
笑魘=笑靨
粉干=粉乾
粉制=粉製
納征=納徵
純朴=純樸
純系=純係
紙扎=紙紮
素朴=素樸
素食=素食
素食面=素食麵
紡鎚=紡錘
索馬=索馬
索馬利裡=索馬利里
索馬裡=索馬里
索馬裡蘭=索馬里蘭
紧扎=緊紮
紧卷=緊捲
紧捂=緊摀
绣象=繡像
缺舌=鴃舌
罢斗=罷鬥
耕获=耕穫
耕獲=耕穫
耗干=耗乾
耻夺=褫奪
胰脏=胰臟
胰髒=胰臟
胶制=膠製
能干=能幹
能干巴巴=能乾巴巴
能干休=能干休
能干系=能干系
能干杯=能乾杯
能干政=能干政
能干涉=能干涉
能干笑=能乾笑
能干耗=能乾耗
能干脆=能乾脆
能干淨=能乾淨
能干著急=能乾著急
能干預=能干預
能干嚎=能乾嚎
能干擱=能乾擱
能干瞪=能乾瞪
能干擾=能干擾
能舍=能捨
能象=能像
能象征=能象徵
能象征性=能象徵性
脈沖=脈衝
脊梁=脊樑
脏腑=臟腑
脏器=臟器
脑干=腦幹
航海=航海
航海歷=航海曆
般准=般準
舰只=艦隻
艳后=豔后
苍术=蒼朮
苍郁=蒼鬱
苏里=蘇里
苏醒=甦醒
茶已=茶已
茶已干=茶已乾
茶干=茶干
茶干掉=荼乾掉
茶干盡=茶乾盡
茶余=茶餘
茶卤=茶滷
茶毒=荼毒
茶鹵=茶滷
茶幾=茶几
草席=草蓆
草管=草管
草管人命=草菅人命
荊朴=荊璞
荐饥=薦饑
袅雄=梟雄
觊幸=覬倖
请托=請託
诸余=諸餘
诸候=諸侯
课余=課餘
课征=課徵
谁干=誰幹
调制=調製
调松=調鬆
调准=調準
財欲=財慾
赶制=趕製
起干=起幹
起來=起來
起來象=起來像
起哄=起鬨
躬敬=恭敬
軒辟=軒闢
軔性=韌性
轿夫=轎伕
较斗=較鬥
较松=較鬆
较准=較準
较象=較像
迷奸=迷姦
迷罔=迷惘
迷迷=迷迷
迷迷蒙蒙=迷迷濛濛
迷蒙=迷濛
迷朦=迷濛
迻邐=迆邐
追凶=追兇
追朔=追溯
追根=追根
追根究抵=追根究柢
追谥=追諡
追謚=追諡
选准=選準
配制=配製
配膳=配膳
配膳台=配膳檯
酒一=酒一
酒一壇=酒一罈
酒已=酒已
酒已干=酒已乾
酒干=酒干
酒干了=酒乾了
酒干掉=酒乾掉
酒干盡=酒乾盡
酒托=酒托
酒曲=酒麴
酒坛=酒罈
酒肴=酒餚
酒壇=酒罈
釘槌=釘鎚
針炙=針灸
針黹=鍼黹
钳口=箝口
钳制=箝制
铁制=鐵製
铁拐=鐵枴
铁练=鐵鍊
铁炼=鐵鍊
铁槌=鐵鎚
閃鑠=閃爍
阃范=閫範
陡松=陡鬆
难舍=難捨
难咽=難嚥
顾恤=顧卹
预布=預佈
预制=預製
飢年=饑年
飢荒=饑荒
飢饉=饑饉
馬夫=馬伕
馬夫人=馬夫人
馬表=馬錶
馬斯=馬斯
馬斯特裡=馬斯特里
馬裡=馬里
馬裡蘭=馬里蘭
馬僵=馬韁
骋凶=騁兇
骨干=骨幹
骨灰=骨灰
骨灰壇=骨灰罈
骨坛=骨罈
骨松=骨鬆
骨壇=骨罈
高干=高幹
高干脆=高乾脆
高升=高昇
鬼谷=鬼谷
鬼谷子=鬼谷子
鸬慈=鸕鶿
倏松=倏鬆
假发=假髮
假發=假髮
做了=做了
做出=做出
做出好戲=做齣好戲
做到=做到
做到象=做到像
停制=停製
停征=停徵
側沖=側衝
偶象=偶像
偷梁=偷樑
偻罗=僂儸
兜卷=兜捲
兽奸=獸姦
兽欲=獸慾
减征=減徵
剪发=剪髮
剪除=翦除
剪彩=剪綵
剪發=剪髮
副丑=副丑
副丑相=副醜相
動蕩=動盪
勘乱=戡亂
勘亂=戡亂
區別=區別
唱游=唱遊
商历=商曆
商周=商周
商朝=商朝
商铺=商舖
商鋪=商舖
商歷=商曆
啟發=啟發
啮齿=囓齒
啰里=囉里
圈梁=圈樑
國小=國小
國小只=國小只
國制=國製
國制定=國制定
國制度=國制度
國制訂=國制訂
國家=國家
國歷=國曆
國歷代=國歷代
國歷史=國歷史
國歷任=國歷任
國歷年=國歷年
國歷屆=國歷屆
國歷經=國歷經
國歷盡=國歷盡
國歷險=國歷險
基干=基幹
基准=基準
够怨=搆怨
够准=夠準
夠不=夠不
夠不著=搆不著
夠怨=搆怨
夠准=夠準
夠涂=夠塗
夠贊=夠讚
夠鐘=夠鐘
夠鐘情=夠鍾情
夠鐘愛=夠鍾愛
婀挪=婀娜
宿舍=宿舍
寂聊=寂寥
寄托=寄託
密布=密佈
密折=密摺
密致=密緻
專干=專幹
屡仆=屢仆
帶征=帶徵
帶發=帶髮
帶著=帶著
常干=常幹
康愈=康癒
強力=強力
強力干性=強力乾性
強力干濕=強力乾濕
強干=強幹
強干杯=強乾杯
強干涉=強干涉
強干脆=強乾脆
強干預=強干預
強干擾=強干擾
強台=強颱
強奸=強姦
強沖=強衝
強征=強徵
強界=疆界
強御=強禦
彩女=綵女
彩凤=綵鳳
彩头=綵頭
彩灯=綵燈
彩衣=綵衣
彩杖=綵杖
彩线=綵線
彩带=綵帶
彩帶=綵帶
彩排=綵排
彩球=綵球
彩绸=綵綢
彩鸾=綵鸞
彩棚=綵棚
彩牌=綵牌
彩筆=彩筆
彩筆生=綵筆生
彩缎=綵緞
彩楼=綵樓
彩綢=綵綢
彩裳=綵裳
彩鳳=綵鳳
彩樓=綵樓
彩線=綵線
彩緞=綵緞
彩缯=綵繒
彩燈=綵燈
彩頭=綵頭
彩繒=綵繒
彩鸞=綵鸞
得准=得準
得准不准=得準不準
得象=得像
徜若=倘若
御制=御製
御侮=禦侮
御敌=禦敵
御寇=禦寇
御寒=禦寒
御敵=禦敵
悠游=悠遊
悬梁=懸樑
悸栗=悸慄
情欲=情慾
惊栗=驚慄
惊螫=驚蟄
惕栗=惕慄
惧栗=懼慄
惨栗=慘慄
戚忧=慼憂
戚戚=慼慼
戚然=慼然
戚嗟=慼嗟
戚憂=慼憂
戚颜=慼顏
戚顏=慼顏
捭合=捭闔
捻手=撚手
捻花=撚花
捻指=撚指
捻胡=捻鬍
捻须=撚鬚
捻香=撚香
捻钱=撚錢
捻須=撚鬚
捻錢=撚錢
掀卷=掀捲
掃卷=掃捲
掃描=掃瞄
掉发=掉髮
掉發=掉髮
掉發出=掉發出
掉發現=掉發現
掉發現象=掉髮現象
排洩=排泄
排骨=排骨
排骨面=排骨麵
掘松=掘鬆
掙松=掙鬆
掛彩=掛綵
掛歷=掛曆
掛礙=罣礙
掠冲=掠衝
掠沖=掠衝
探知=探知
探知欲=探知慾
接斗=接鬥
控制=控制
控制面板=控制面板
控制欲=控制慾
推刨=推鉋
推情=推情
推情准理=推情準理
掸子=撢子
敖游=敖遊
教范=教範
教悔=教誨
斛斗=觔斗
斜冲=斜衝
斜沖=斜衝
断发=斷髮
旋卷=旋捲
旋松=旋鬆
旋涡=漩渦
旋渦=漩渦
桿面=桿麵
梁上=樑上
梁下=樑下
梁折=樑折
梁国=梁國
梁柱=樑柱
梁脊=樑脊
梗直=鯁直
梦回=夢迴
梦系=夢繫
梦游=夢遊
梯冲=梯衝
梯沖=梯衝
械斗=械鬥
棄舍=棄捨
欲女=慾女
欲火=慾火
欲令=欲令
欲令智昏=慾令智昏
欲求=欲求
欲求不滿=慾求不滿
欲念=慾念
欲舍=欲捨
欲海=慾海
欲望=慾望
欲障=慾障
欲壑=慾壑
欲孽=慾孽
欷籲=欷吁
毫发=毫髮
毫厘=毫釐
毫發=毫髮
液晶=液晶
液晶表=液晶錶
涼面=涼麵
涼席=涼蓆
淀粉=澱粉
淑范=淑範
淒息=棲息
淒戚=悽慼
淚干=淚乾
淚難=淚難
淚難干=淚難乾
淨余=淨餘
淨幾=淨几
淫欲=淫慾
淬厉=淬礪
淬厲=淬礪
淳朴=淳樸
淳於=淳于
混肴=混淆
清国=清國
清掃=清掃
清掃夫=清掃伕
清淅=清晰
清理=清理
清朝=清朝
清道=清道
清道夫=清道伕
渐松=漸鬆
渐愈=漸癒
烹制=烹製
焊接=銲接
牽一=牽一
牽一發=牽一髮
牽系=牽繫
犁牛=犛牛
猛干=猛幹
猛斗=猛鬥
猛冲=猛衝
猛沖=猛衝
猛卷=猛捲
猜准=猜準
現丑=現醜
現象=現象
球台=球檯
球果=毬果
球桿=球杆
球童=球僮
琅当=琅璫
琅當=琅璫
琅嬛=瑯嬛
理发=理髮
理發=理髮
瓶白=瓶白
瓶白干=瓶白乾
瓷制=瓷製
甜面=甜面
甜面醬=甜麵醬
略干=略乾
略松=略鬆
畦径=畦逕
畦徑=畦逕
疏松=疏鬆
疏浚=疏濬
痊愈=痊癒
盗采=盜採
盘回=盤迴
盘卷=盤捲
盘涅=槃涅
盘游=盤遊
盛贊=盛讚
眼困=眼睏
眼花=眼花
眼花了亂=眼花瞭亂
眼框=眼眶
着干=著幹
祭吊=祭弔
移逦=迆邐
窒欲=窒慾
竟斗=竟斗
竟斗不=竟鬥不
竟象=竟像
符录=符籙
符錄=符籙
粗朴=粗樸
粗制=粗製
累累=纍纍
細致=細緻
绪余=緒餘
续弦=續絃
维护=維護
维系=維繫
绸密=稠密
绾发=綰髮
羞赦=羞赧
翊赞=翊贊
聊天=聊天
聊齋=聊齋
聊齋志異=聊齋誌異
脚夫=腳伕
脚注=腳註
脚炼=腳鍊
脣干=脣乾
脫發=脫髮
脱发=脫髮
舂谷=舂穀
舶船=泊船
船夫=船伕
船只=船隻
船纤=船縴
船浆=船槳
船梁=船樑
船漿=船槳
船蓬=船篷
船纖=船縴
荷裡=荷裡
荷裡活=荷里活
莒光=莒光
莒光周=莒光週
莖干=莖幹
莫明=莫明
莫明其妙=莫名其妙
莫裡=莫里
處高=處高
處高務遠=處高鶩遠
虚象=虛像
蛋卷=蛋捲
衔土=啣土
衔泥=啣泥
衔环=啣環
衔草=啣草
袖一=袖一
袖一卷=袖一捲
被干=被幹
被干涉=被干涉
被干預=被干預
被干擾=被干擾
被并=被併
被並=被併
被卷=被捲
被复=被覆
被復=被覆
被發=被發
被發左衽=被髮左衽
被褥=被縟
袭卷=襲捲
規划=規劃
規范=規範
覓准=覓準
谋干=謀幹
貪欲=貪慾
赈饥=賑饑
躯干=軀幹
軟發=軟髮
辅赞=輔贊
透辟=透闢
递回=遞迴
這出=這出
這出好戲=這齣好戲
這出電影=這齣電影
這出劇=這齣劇
這出戲=這齣戲
這伙=這伙
這伙人=這夥人
這般=這般
這般干法=這般幹法
這般准=這般準
這麼=這麼
這麼干=這麼幹
這麼丑=這麼醜
這麼准=這麼準
這麼像征=這麼象徵
通心=通心
通心面=通心麵
通奸=通姦
通浚=通濬
通谍=通牒
通辑=通緝
通諜=通牒
通輯=通緝
逞凶=逞兇
速干=速乾
速食=速食
速食面=速食麵
造象=造像
連斗=連鬥
連抉=連袂
連系=連繫
連系統=連系統
連傑=連杰
連絡=聯絡
部落=部落
郭朴=郭璞
都肯=都肯
都肯干=都肯幹
都舍=都舍
都舍下=都捨下
都象=都像
野游=野遊
釣游=釣遊
釵環=釵鐶
铜制=銅製
铜象=銅像
铝制=鋁製
铰炼=鉸鍊
铲刈=剷刈
铲去=剷去
铲平=剷平
铲灭=剷滅
铲起=剷起
铲除=剷除
银制=銀製
银须=銀鬚
陪吊=陪弔
陪著=陪著
陰干=陰乾
陰郁=陰鬱
陰歷=陰曆
陷井=陷阱
頂凶=頂兇
頂頂=頂頂
頂頂大名=鼎鼎大名
颇准=頗準
颇象=頗像
颈系=頸繫
魚干=魚乾
魚干擾=魚干擾
魚松=魚鬆
鸿范=鴻範
鸿准=鴻準
鹵水=滷水
鹵牛=鹵牛
鹵牛肉=滷牛肉
鹵汁=滷汁
鹵肉=滷肉
鹵制=滷製
鹵味=滷味
鹵面=滷麵
鹵蛋=滷蛋
鹵菜=滷菜
鹵醬=滷醬
鹵雞=滷雞
鹵鵝=滷鵝
麥面=麥麵
麻疯=痲瘋
麻病=痲病
麻瘋=痲瘋
黄历=黃曆
黄发=黃髮
亵读=褻瀆
傅裡=傅裡
傅裡葉=傅里葉
傍徨=徬徨
傑倫=杰倫
傒幸=傒倖
備注=備註
凱裡=凱里
剩余=剩餘
剩肴=剩餚
割舍=割捨
創制=創製
勝余=勝餘
勞力=勞力
勞力士表=勞力士錶
勞騷=牢騷
博斗=博鬥
厨余=廚餘
唾面=唾面
唾面自干=唾面自乾
啷当=啷噹
啷當=啷噹
喂马=餵馬
喂它=餵牠
喂羊=餵羊
喂鱼=餵魚
喂馬=餵馬
喂動=喂動
喂動物=餵動物
喂魚=餵魚
喂猪=餵豬
喂豬=餵豬
善斗=善鬥
喉干=喉乾
喉干舌燥=喉乾舌燥
喉頭=喉頭
喉頭發干=喉頭發乾
喑哑=瘖啞
喑啞=瘖啞
喝一=喝一
喝一壇=喝一罈
喝三=喝三
喝三壇=喝三罈
喝干=喝乾
喝斗=喝斗
喝斗聲=喝鬥聲
喝白=喝白
喝白干=喝白乾
喝兩=喝兩
喝兩壇=喝兩罈
喧染=渲染
單於=單于
單單=單單
喽罗=嘍囉
報道=報導
報廢=報廢
報廢後=報廢後
壺范=壺範
孱杂=羼雜
孱雜=羼雜
富余=富餘
寒仓=寒傖
寒而=寒而
寒而栗=寒而慄
寒倉=寒傖
寒栗=寒慄
寒喧=寒暄
尊范=尊範
尋准=尋準
尋麻=蕁麻
就干=就干
就干一=就幹一
就干一杯=就乾一杯
就干吧=就幹吧
就干杯=就乾杯
就干涉=就干涉
就干脆=就乾脆
就干淨=就乾淨
就干爽=就乾爽
就干預=就干預
就干擾=就干擾
就吃=就吃
就吃干=就吃乾
就范=就範
就象=就像
就像征=就象徵
属制=屬製
嵇首=稽首
帽璎=帽纓
帽瓔=帽纓
幾天后=幾天後
幾乎=幾乎
幾乎象=幾乎像
幾出=幾齣
幾只=幾隻
幾周=幾週
幾個=幾個
幾案=几案
幾海=幾海
幾海裡=幾海里
幾淨=几淨
幾裡=幾里
强干=強幹
强台=強颱
强冲=強衝
强奸=強姦
强国=強國
强征=強徵
强界=疆界
强御=強禦
彭咸=彭咸
徨恐=惶恐
復亡=覆亡
復分=復分
復分解=複分解
復分數=複分數
復文=覆文
復方=複方
復比=複比
復水=復水
復水難收=覆水難收
復仞=復仞
復仞年如=複仞年如
復以=復以
復以百萬=複以百萬
復句=複句
復本=複本
復目=複目
復列=複列
復印=複印
復合=復合
復合包裝=複合包裝
復合字=複合字
復合式=複合式
復合技=複合技
復合材料=複合材料
復合性=複合性
復合板=複合板
復合物=複合物
復合金屬=複合金屬
復合型=複合型
復合架=複合架
復合詞=複合詞
復合傳動=複合傳動
復合裝甲=複合裝甲
復合管=複合管
復合增長=複合增長
復合模=複合模
復合膜=複合膜
復合機=複合機
復合藥=複合藥
復合體=複合體
復名=復名
復字=復字
復字鍵=複字鍵
復式=複式
復次=複次
復舟=覆舟
復色=複色
復利=複利
復決=複決
復沒=覆沒
復車=復車
復車之戒=覆車之戒
復函=覆函
復制=複製
復命=覆命
復姓=複姓
復信=覆信
復查=複查
復相=復相
復相關=複相關
復述=複述
復音=複音
復書=覆書
復核=覆核
復基=復基
復基因=複基因
復巢=覆巢
復敗=覆敗
復眼=複眼
復習=複習
復復=覆覆
復測=複測
復診=複診
復詞=複詞
復滅=覆滅
復葉=複葉
復試=複試
復電=覆電
復種=複種
復蓋=覆蓋
復審=覆審
復寫=複寫
復數=複數
復線=複線
復閱=複閱
復壁=複壁
復選=複選
復錢=複錢
復檢=複檢
復賽=複賽
復轍=覆轍
復雜=複雜
復韻=複韻
復蘇=復甦
復疊=覆疊
復變=複變
悲泯=悲憫
悲郁=悲鬱
悲戚=悲慼
悶郁=悶鬱
惡心=噁心
惡斗=惡鬥
惴栗=惴慄
惶栗=惶慄
惺松=惺忪
捶台=捶台
捶台拍凳=捶檯拍凳
掌握=掌握
揉制=揉製
揉面=揉麵
揉躏=蹂躪
揉躪=蹂躪
描涂=描塗
換只=換隻
換簽=換籤
握不=握不
握不准=握不準
握发=握髮
握准=握準
握發=握髮
握著=握著
揩干=揩乾
揩台=揩檯
揪采=揪採
揭丑=揭醜
揮別=揮別
揮卷=揮捲
揮桿=揮杆
揮發=揮發
揮發油=揮發油
摒息=屏息
敢干=敢幹
敢斗=敢鬥
敢再=敢再
敢再干杯=敢再乾杯
敢念=敢唸
敢松=敢鬆
敢拼=敢拚
散布=散佈
散伙=散夥
散署=佈署
敦朴=惇樸
敦厚=惇厚
敦敦=惇惇
敦睦=惇睦
敦誨=惇誨
敦篤=惇篤
敦謹=惇謹
斑烂=斑斕
斑爛=斑斕
斯裡=斯里
普裡=普里
景致=景緻
智斗=智鬥
晾干=晾乾
暂松=暫鬆
最丑=最醜
最准=最準
朝干=朝乾
棉制=棉製
棕发=棕髮
棕發=棕髮
棟梁=棟樑
棵象=棵像
植发=植髮
植發=植髮
欺蒙=欺矇
欽崎=嶔崎
殘干=殘幹
殘余=殘餘
殘肴=殘餚
殘廢=殘廢
殘廢後=殘廢後
減征=減徵
渠冲=渠衝
渠沖=渠衝
測不=測不
測不准=測不準
測准=測準
港制=港製
游人=遊人
游刃=遊刃
游子=遊子
游山=遊山
游中=游中
游中國=遊中國
游历=遊歷
游斗=游鬥
游方=遊方
游乐=遊樂
游仙=遊仙
游北=游北
游北美=遊北美
游台=游台
游台灣=遊台灣
游必=游必
游必有方=遊必有方
游目=遊目
游记=遊記
游兴=遊興
游军=遊軍
游戏=遊戲
游行=遊行
游观=遊觀
游伴=遊伴
游兵=遊兵
游冶=遊冶
游园=遊園
游巡=遊巡
游艺=遊藝
游走=遊走
游亞=游亞
游亞洲=遊亞洲
游侠=遊俠
游学=遊學
游牧=遊牧
游狎=遊狎
游玩=遊玩
游非=游非
游非洲=遊非洲
游俠=遊俠
游客=遊客
游宦=遊宦
游星=遊星
游美=游美
游美洲=遊美洲
游览=遊覽
游说=遊說
游軍=遊軍
游香=游香
游香港=遊香港
游記=遊記
游唱=遊唱
游猎=遊獵
游船=遊船
游逛=遊逛
游骑=遊騎
游廊=遊廊
游惰=遊惰
游湖=遊湖
游荡=遊蕩
游街=遊街
游園=遊園
游艇=遊艇
游蜂=遊蜂
游遍=遊遍
游错=遊錯
游說=遊說
游魂=遊魂
游樂=遊樂
游歐=游歐
游歐洲=遊歐洲
游踪=遊蹤
游學=遊學
游憩=遊憩
游歷=遊歷
游澳=游澳
游澳洲=遊澳洲
游興=遊興
游蕩=遊蕩
游豫=遊豫
游錯=遊錯
游戲=遊戲
游獵=遊獵
游蹤=遊蹤
游騎=遊騎
游藝=遊藝
游覽=遊覽
游觀=遊觀
渾函=渾涵
湧卷=湧捲
湮郁=湮鬱
湯面=湯麵
湯團=湯糰
湿发=濕髮
焙干=焙乾
焚毀=焚燬
焚毁=焚燬
無余=無餘
無梁=無樑
無欲=無慾
無煙=無煙
無煙室=無菸室
無煙餐廳=無菸餐廳
無煙環境=無菸環境
無釐=無釐
無釐頭=無厘頭
焦干=焦乾
然斗=然斗
然斗不=然鬥不
然無=然無
然無幸=然無倖
然象=然像
煮面=煮麵
猪只=豬隻
猶太=猶太
猶太歷=猶太曆
琢制=琢製
琳琅=琳瑯
琺琅=琺瑯
番薯=蕃薯
畫象=畫像
畫餅=畫餅
畫餅充飢=畫餅充饑
痙孿=痙攣
發干=發乾
發布=發佈
發如=發如
發如飛蓬=髮如飛蓬
發式=髮式
發色=髮色
發夾=髮夾
發束=髮束
發乳=髮乳
發卷=髮捲
發妻=髮妻
發姐=髮姐
發油=髮油
發表=發表
發表欲=發表慾
發長=髮長
發長音=發長音
發冠=髮冠
發型=髮型
發指=髮指
發指令=發指令
發面=發麵
發香=髮香
發套=髮套
發挽=發挽
發挽雙髻=髮挽雙髻
發根=髮根
發梳=髮梳
發針=髮針
發帶=髮帶
發梢=髮梢
發釵=髮釵
發廊=髮廊
發皓=髮皓
發絲=髮絲
發菜=髮菜
發須=發須
發須已=髮鬚已
發須皆=髮鬚皆
發須俱=髮鬚俱
發須都=髮鬚都
發須斑=髮鬚斑
發亂=發亂
發亂釵橫=髮亂釵橫
發飾=髮飾
發箋=髮箋
發箍=髮箍
發際=髮際
發膚=髮膚
發膠=髮膠
發質=髮質
發醅=醱醅
發髯=髮髯
發雕=髮雕
發髻=髮髻
發霜=髮霜
發簪=髮簪
發辮=髮辮
發蠟=髮蠟
發纓=髮纓
發黴=發霉
發鬢=髮鬢
皓发=皓髮
皓發=皓髮
盜采=盜採
短小=短小
短小精干=短小精悍
短发=短髮
短须=短鬚
短發=短髮
短發性=短發性
短須=短鬚
硬干=硬幹
硬发=硬髮
硬冲=硬衝
硬沖=硬衝
硬拼=硬拚
硬發=硬髮
确系=確係
稀松=稀鬆
稀裡=稀里
稍干=稍干
稍干的=稍乾的
稍有=稍有
稍有不准=稍有不準
稍松=稍鬆
窗台=窗檯
童仆=僮僕
童婢=僮婢
筆禿=筆禿
筆禿墨干=筆禿墨乾
等侯=等候
筋斗=觔斗
筍干=筍乾
筍況=荀況
答复=答覆
答復=答覆
策勳=策勛
紫姜=紫薑
結扎=結紮
結伙=結夥
結余=結餘
結彩=結綵
結發=結髮
絞干=絞乾
給他=給他
給他干糧=給他乾糧
給她=給她
給她干糧=給她乾糧
給你=給你
給你干糧=給你乾糧
給我=給我
給我干淨=給我乾淨
絲制=絲製
絲弦=絲絃
缈茫=渺茫
缉凶=緝兇
缓冲=緩衝
缓征=緩徵
编发=編髮
编采=編採
编篡=編纂
羡余=羨餘
翕辟=翕闢
联系=聯繫
联征=聯徵
脺脏=脺臟
脺髒=脺臟
脾脏=脾臟
脾髒=脾臟
腌制=醃製
腌臜=腌臢
腎髒=腎臟
腑脏=腑臟
腑髒=腑臟
腕表=腕錶
舄湖=潟湖
舒卷=舒捲
舒寧=舒寧
舒寧咸=舒寧咸
荆朴=荊璞
荡口=盪口
荡开=盪開
荡舟=盪舟
荧光=螢光
荧屏=螢屏
荧郁=熒鬱
荧幕=螢幕
荫郁=蔭鬱
药材=藥材
药制=藥製
药签=藥籤
菜干=菜乾
菜肴=菜餚
華胄=華胄
華裡=華裡
華裡沙=華里沙
著干=著幹
虛象=虛像
蛩音=跫音
蛮干=蠻幹
蛮准=蠻準
裁并=裁併
裁並=裁併
裁制=裁製
装璜=裝潢
觞子=殤子
評注=評註
評擊=抨擊
詞余=詞餘
詞匯=詞彙
詠嘆=詠歎
象一=像一
象二=像二
象人=像人
象三=像三
象个=像個
象么=像麼
象已=像已
象不=象不
象不像=像不像
象之=象之
象之前=像之前
象什=像什
象今=像今
象水=像水
象片=像片
象牙=象牙
象牙齒=像牙齒
象风=像風
象他=像他
象以=象以
象以往=像以往
象以前=像以前
象它=像它
象平=象平
象平時=像平時
象永=像永
象刚=像剛
象吗=像嗎
象在=像在
象她=像她
象当=像當
象有=像有
象自=象自
象自己=像自己
象两=像兩
象似=像似
象你=像你
象別=像別
象别=像別
象我=像我
象那=像那
象些=像些
象兩=像兩
象其=像其
象往=像往
象征=象徵
象征服=像征服
象征戰=像征戰
象所=象所
象所有=像所有
象极=像極
象现=像現
象话=像話
象这=像這
象雨=像雨
象带=像帶
象昨=像昨
象是=像是
象甚=像甚
象疯=像瘋
象要=像要
象風=像風
象個=像個
象剛=像剛
象样=像樣
象素=像素
象谁=像誰
象鬼=像鬼
象帶=像帶
象您=像您
象梦=像夢
象現=像現
象這=像這
象银=像銀
象嗎=像嗎
象極=像極
象當=像當
象話=像話
象過=象過
象過去=像過去
象夢=像夢
象瘋=像瘋
象銀=像銀
象麼=像麼
象樣=像樣
象誰=像誰
象赞=像贊
象贊=像贊
貴干=貴幹
貴胄=貴胄
買凶=買兇
買姜=買薑
買煙=買菸
貼志=貼誌
貼著=貼著
赌斗=賭鬥
赌台=賭檯
赐复=賜覆
超征=超徵
越丑=越醜
越斗=越鬥
越卷=越捲
越国=越國
越咸=越鹹
越准=越準
越象=越像
跌冲=跌衝
跌沖=跌衝
跖骨=蹠骨
践道=棧道
軫域=畛域
鄉裡=鄉里
鄉願=鄉愿
鄉願意=鄉願意
酣斗=酣鬥
酥松=酥鬆
铺位=舖位
销溶=銷鎔
锁炼=鎖鍊
锁碎=瑣碎
開征=開徵
開采=開採
開浚=開濬
開辟=開闢
開鋪=開舖
閒余=閒餘
閒游=閒遊
閒遐=閒暇
閒靜=閑靜
間不=間不
間不容發=間不容髮
陽春=陽春
陽春面=陽春麵
陽歷=陽曆
隆准=隆準
隋国=隋國
隋朝=隋朝
雄赳=雄赳
雄赳赳=雄糾糾
雅致=雅緻
雅范=雅範
集游=集游
集游法=集遊法
集團=集團
雇人=僱人
雇马=僱馬
雇不=雇不
雇不起=僱不起
雇车=僱車
雇主=僱主
雇用=僱用
雇农=僱農
雇有=僱有
雇舟=僱舟
雇佣=僱傭
雇员=僱員
雇役=僱役
雇車=僱車
雇員=僱員
雇请=僱請
雇馬=僱馬
雇船=僱船
雇傭=僱傭
雇農=僱農
雇請=僱請
雲：=云：
雲吞面=雲吞麵
雲宵=雲霄
雲游=雲遊
雲雲=云云
雲爾=云爾
韩制=韓製
韩国=韓國
項煉=項鍊
順發=順發
順發水=順髮水
順發素=順髮素
順發液=順髮液
順發凝露=順髮凝露
順發霧=順髮霧
順發露=順髮露
順順=順順
順順當當=順順當當
須子=鬚子
須毛=鬚毛
須求=需求
須采=須採
須眉=鬚眉
須叟=須臾
須根=鬚根
須發=鬚髮
須發文=須發文
須發表=須發表
須發展=須發展
須須=鬚鬚
須髯=鬚髯
須鯨=鬚鯨
須鬢=鬚鬢
颊须=頰鬚
颌须=頜鬚
飩面=飩麵
飯團=飯糰
飲一=飲一
飲一壇=飲一罈
飲三=飲三
飲三壇=飲三罈
飲干=飲乾
飲白=飲白
飲白干=飲白乾
飲而=飲而
飲而干=飲而乾
飲兩=飲兩
飲兩壇=飲兩罈
馈赠=餽贈
鹅准=鵝準
黃金=黃金
黃金周=黃金週
黃發=黃髮
黃發垂髫=黃髮垂髫
黃歷=黃曆
黑发=黑髮
黑亮=黑亮
黑亮發=黑亮髮
黑须=黑鬚
黑發=黑髮
黑發暗=黑發暗
黑須=黑鬚
亂斗=亂鬥
亂沖=亂衝
亂涂=亂塗
傭金=佣金
傭錢=佣錢
傳布=傳佈
傷愈=傷癒
傷難=傷難
傷難愈=傷難癒
傾刻=頃刻
傾復=傾覆
僂羅=僂儸
僅余=僅餘
勤朴=勤樸
匯刊=彙刊
匯萃=薈萃
匯集=彙集
匯編=彙編
匯整=彙整
匯輯=彙輯
匯總=彙總
匯纂=彙纂
嗟籲=嗟吁
園游=園游
園游會=園遊會
圓椎=圓錐
塑象=塑像
塔裡=塔裡
塔裡木=塔里木
奧斯=奧斯
奧斯卡=奧斯卡
嫌凶=嫌兇
微松=微鬆
微软=微軟
微须=微鬚
微須=微鬚
想干=想幹
想干笑=想乾笑
想干脆=想乾脆
想干淨=想乾淨
想斗=想鬥
想著=想著
想象=想像
愁郁=愁鬱
愈斗=愈斗
愈斗愈=愈鬥愈
愈合=癒合
愈合心=愈合心
愈合乎=愈合乎
愈合他=愈合他
愈合用=愈合用
愈合她=愈合她
愈合式=愈合式
愈合作=愈合作
愈合我=愈合我
愈合身=愈合身
愈合拍=愈合拍
愈合於=愈合於
愈合得=愈合得
愈合情=愈合情
愈合理=愈合理
愈合意=愈合意
愈合適=愈合適
愈合攏=愈合攏
愈卷=愈捲
愈疮=癒瘡
愈象=愈像
愈瘡=癒瘡
意函=意涵
意興=意興
意興闌姍=意興闌珊
愚暗=愚闇
愛屋=愛屋
愛屋及鳥=愛屋及烏
愛欲=愛慾
感染=感染
感覺=感覺
感覺象=感覺像
搏斗=搏鬥
搜证=蒐證
搜罗=蒐羅
搜购=蒐購
搜集=蒐集
搜購=蒐購
搜羅=蒐羅
搜證=蒐證
摄制=攝製
摄服=懾服
摄象=攝像
摆布=擺佈
摆荡=擺盪
数只=數隻
数里=數里
数周=數週
新历=新曆
新征=新徵
新舄=新潟
新歷=新曆
新歷史=新歷史
暗斗=暗鬥
暗伦=闇倫
暗劣=闇劣
暗倫=闇倫
暗冥=闇冥
暗弱=闇弱
暗然=闇然
暗藏=暗藏
暗藏著=暗藏著
暗贊=暗讚
會干=會幹
會干杯=會乾杯
會干脆=會乾脆
會干涸=會乾涸
會干淨=會乾淨
會干裂=會乾裂
會干擾=會干擾
會斗=會鬥
會象=會像
會象棋=會象棋
楚国=楚國
業余=業餘
極干=極乾
極丑=極醜
極待=極待
極待救=亟待救
極待解=亟待解
極准=極準
極象=極像
極極=亟亟
榔头=鎯頭
榔頭=鎯頭
毀謗=譭謗
毁谤=譭謗
溜达=溜躂
溜須=溜須
溜須拍馬=溜鬚拍馬
溜達=溜躂
溪壑=谿壑
溶岩=熔岩
溶炉=熔爐
溶接=熔接
溶铸=熔鑄
溶销=熔銷
溶銷=熔銷
溶爐=熔爐
溶鑄=熔鑄
滚卷=滾捲
满布=滿佈
滥征=濫徵
煉子=鍊子
煉制=煉製
煉鎖=鍊鎖
煎制=煎製
煙民=菸民
煙灰=菸灰
煙沒=湮沒
煙卷=菸捲
煙客=菸客
煙草=菸草
煙酒=菸酒
煙鬼=菸鬼
煙商=菸商
煙焦=煙焦
煙焦油=菸焦油
煙槍=菸槍
煙熏=煙燻
煙頭=菸頭
煙齡=菸齡
煙癮=菸癮
照干=照幹
照准=照準
照象=照像
煨干=煨乾
煩郁=煩鬱
猷豫=猶豫
瑞哲=睿哲
瑞智=睿智
當一=當一
當一聲=噹一聲
當年=當年
當局=當局
當其=當其
當其沖=當其衝
當周=當週
當周潤發=當周潤發
當的=當的
當的一聲=噹的一聲
當的一響=噹的一響
當郎=噹啷
當准=當準
當啷=噹啷
當然=當然
當然羅！=當然囉！
當當=噹噹
當當當=噹噹噹
碎发=碎髮
碎發=碎髮
碑志=碑誌
碗干=碗乾
碗白=碗白
碗白干=碗白乾
碗面=碗麵
碗素=碗素
碗素面=碗素麵
禀复=稟覆
禁若=禁若
禁若寒蟬=噤若寒蟬
禁烟=禁菸
禁欲=禁慾
禁煙=禁菸
稟復=稟覆
窣悉=窣窸
窥准=窺準
签卜=籤卜
签文=籤文
签爪=籤爪
签条=籤條
签诗=籤詩
签筒=籤筒
简朴=簡樸
節余=節餘
節欲=節慾
綁扎=綁紮
經斗=經斗
經斗數=經鬥數
經白=經白
經白干=經白幹
經理=經理
缜致=縝緻
缝扎=縫紮
缝纴=縫紉
缝制=縫製
缠斗=纏鬥
缠卷=纏捲
罩卷=罩捲
罩准=罩準
群斗=群鬥
群象=群像
聖杯=聖盃
聖象=聖像
聖跡=聖蹟
聖嘆=聖歎
聘雇=聘僱
肆业=肄業
肆業=肄業
腦干=腦幹
腮胡=腮鬍
腰一=腰一
腰一卷=腰一捲
腰干=腰幹
腰系=腰繫
腰間=腰間
腰間系=腰間繫
腳夫=腳伕
腳注=腳註
腳煉=腳鍊
腸髒=腸臟
腼典=靦腆
萬扎=萬紮
萬只=萬隻
萬只怕=萬只怕
萬余=萬餘
萬余只=萬餘隻
萬余裡=萬餘里
萬海=萬海
萬海裡=萬海里
萬裡=萬里
萬歷=萬曆
落发=落髮
落發=落髮
葉裡=葉裡
葉裡溫=葉里溫
葡萄=葡萄
葡萄干=葡萄乾
葱郁=蔥鬱
號志=號誌
蜀国=蜀國
裊雄=梟雄
裔胄=裔胄
裕余=裕餘
裙摆=裙襬
裙擺=裙襬
補注=補註
裝璜=裝潢
裡士=裡士
裡士滿=里士滿
裡仁=里仁
裡夫=里夫
裡尼=里尼
裡布=里布
裡民=里民
裡肌=里肌
裡余=裡餘
裡里=里奇
裡亞=里亞
裡拉=里拉
裡昂=里昂
裡長=里長
裡科=里科
裡約=里約
裡美=里美
裡面=裡面
裡面沖=裡面衝
裡面沖水=裡面沖水
裡面沖身=裡面沖身
裡面沖洗=裡面沖洗
裡面沖涼=裡面沖涼
裡面沖澡=裡面沖澡
裡根=里根
裡納=里納
裡斯=裡斯
裡斯本=里斯本
裡程=里程
裡象=裡像
裡奧=里奧
裡路=里路
裡爾=里爾
裡蘭=里蘭
解象=解像
解雇=解僱
解签=解籤
解簽=解籤
解簽約=解簽約
触须=觸鬚
試卷=試卷
詩余=詩餘
詩雲=詩云
話雲=話云
該象=該像
該像征=該象徵
詳征=詳徵
詳注=詳註
誇父=夸父
誇克=夸克
誇克星=夸克星
誇特=夸特
誇脫=夸脫
誇爾=夸爾
誇贊=誇讚
誠朴=誠樸
誠征=誠徵
跟女=跟女
跟女斗=跟女鬥
跟斗=觔斗
跟他=跟他
跟他一斗=跟他一鬥
跟他斗=跟他鬥
跟她=跟她
跟她斗=跟她鬥
跟你=跟你
跟你斗=跟你鬥
跟我=跟我
跟我斗=跟我鬥
跟跄=踉蹌
跟蹌=踉蹌
路签=路籤
路裡=路里
路簽=路籤
跳只=跳只
跳只舞=跳隻舞
跳表=跳錶
跳梁=跳樑
較丑=較醜
較斗=較鬥
較松=較鬆
較准=較準
較象=較像
較像征=較象徵
辑凶=輯兇
辞汇=辭彙
辟土=闢土
辟为=闢為
辟田=闢田
辟划=闢劃
辟地=闢地
辟佛=闢佛
辟作=闢作
辟谷=辟榖
辟邪=闢邪
辟門=辟門
辟門戶=闢門戶
辟室=闢室
辟建=闢建
辟為=闢為
辟透=闢透
辟筑=闢築
辟谣=闢謠
辟谬=闢謬
辟阖=闢闔
辟劃=闢劃
辟築=闢築
辟謠=闢謠
辟蹊=辟蹊
辟蹊徑=闢蹊徑
辟謬=闢謬
辟闔=闢闔
農民=農民
農民歷=農民曆
農歷=農曆
農獲=農穫
逼奸=逼姦
逾年=踰年
逾闲=踰閒
逾矩=踰矩
逾越=踰越
逾閒=踰閒
遇著=遇著
運籌=運籌
運籌惟幄=運籌帷幄
遍布=遍佈
過松=過鬆
遐胄=遐胄
遐疵=瑕疵
道坎=道檻
道裡=道里
道贊=道讚
遗范=遺範
遗迹=遺蹟
遗象=遺像
遗撼=遺憾
酬傭=酬佣
酱面=醬麵
鉗口=箝口
鉗制=箝制
鉛鎚=鉛錘
锡制=錫製
锡坤=錫堃
锦镖=錦標
锱衣=緇衣
阖府=閤府
阖家=閤家
隔周=隔週
電子=電子
電子表=電子錶
電子表示=電子表示
電子表格=電子表格
電子表情=電子表情
電子表單=電子表單
電子鐘=電子鐘
電桿=電杆
電影=電影
電影後=電影後
電線=電線
電線桿=電線杆
頌贊=頌讚
預布=預佈
預制=預製
颓圯=頹圮
鼎邊=鼎邊
鼎邊剉=鼎邊銼
像征=象徵
像赞=像贊
像贊他=像讚他
像贊她=像讚她
像贊你=像讚你
像贊我=像讚我
像贊美=像讚美
像贊許=像讚許
像贊揚=像讚揚
像贊頌=像讚頌
像贊嘆=像讚嘆
像贊賞=像讚賞
像贊譽=像讚譽
僕地=仆地
僕倒=仆倒
僕然=仆然
僕街=仆街
僥天=僥天
僥天之幸=僥天之悻
僥幸=僥倖
僥悻=僥倖
劃子=划子
劃不=劃不
劃不來=劃不來
劃水=划水
劃去=划去
劃舟=划舟
劃步=划步
劃來=划來
劃拳=划拳
劃船=划船
劃單=劃單
劃單人艇=划單人艇
劃艇=划艇
劃算=划算
劃槳=划槳
劃獨=划獨
劃龍=划龍
劃雙=劃雙
劃雙人=划雙人
厮斗=廝鬥
嘆服=歎服
嘆為=歎為
嘆羨=歎羨
嘆賞=歎賞
嘆籲=嘆吁
嘍羅=嘍囉
嘘唏=歔欷
圖象=圖像
團子=糰子
團伙=團夥
團粉=糰粉
墓志=墓誌
壽面=壽麵
夢回=夢迴
夢系=夢繫
夢游=夢遊
奪斗=奪鬥
奪杯=奪盃
寡欲=寡慾
實干=實幹
實象=實像
寧舍=寧捨
對干=對幹
對准=對準
對華=對華
對著=對著
對象征=對象徵
屢僕=屢仆
愿干=願幹
慘栗=慘慄
慢咽=慢嚥
摸不=摸不
摸不准=摸不準
摸准=摸準
摺雲=摺云
旗桿=旗杆
旗幡=旗旛
暝目=瞑目
暢游=暢遊
榨干=榨乾
榨甘=榨甘
榨甘蔗=搾甘蔗
榨取=搾取
榨渣=搾渣
榴连=榴槤
榴連=榴槤
構陷=搆陷
槌头=鎚頭
槌打=搥打
槌背=搥背
槌胸=搥胸
槌鼓=搥鼓
槌頭=鎚頭
歉咎=歉疚
滴干=滴乾
滾卷=滾捲
滿布=滿佈
漓水=灕水
漓江=灕江
漓湘=灕湘
漢周=漢周
漫游=漫遊
漬已=漬已
漬已干=漬已乾
漸松=漸鬆
漸愈=漸癒
熏肉=燻肉
熏制=燻製
熏烟=燻煙
熏热=燻熱
熏鸭=燻鴨
熏煮=燻煮
熏猪=燻豬
熏鹅=燻鵝
熏黑=燻黑
熏煙=燻煙
熏熏=燻燻
熏蒸=燻蒸
熏熟=燻熟
熏熱=燻熱
熏豬=燻豬
熏鴨=燻鴨
熏鵝=燻鵝
熒光=螢光
熒屏=螢屏
熒郁=熒鬱
熒幕=螢幕
熔毀=熔燬
熔毁=熔燬
瑤簽=瑤籤
瑶签=瑤籤
疑系=疑係
盡干=盡幹
盡可=盡可
盡可能=儘可能
盡先=儘先
盡早=儘早
盡有=盡有
盡有可能=儘有可能
盡是=儘是
盡夠=儘夠
盡教=儘教
盡量=儘量
盡管=儘管
監制=監製
睡眠=睡眠
睡眠欲=睡眠慾
瞄不=瞄不
瞄不准=瞄不準
瞄准=瞄準
瞅不=瞅不
瞅不准=瞅不準
瞅准=瞅準
碧咸=碧咸
磁制=磁製
種谷=種穀
種放=种放
種師=種師
種師中=种師中
種師道=种師道
種發=種發
種發式=種髮式
稱贊=稱讚
稳扎=穩紮
窩裡=窩裡
窩裡斗=窩裡鬥
算不=算不
算不准=算不準
算丑=算醜
算准=算準
管理=管理
箩卜=蘿蔔
箫条=蕭條
精干=精幹
精制=精製
精致=精緻
精准=精準
精辟=精闢
綜合=綜合
綜合征=綜合徵
綢密=稠密
維系=維繫
綰發=綰髮
網志=網誌
網游=網遊
緊扎=緊紮
緊卷=緊捲
緒余=緒餘
缩栗=縮慄
腐余=腐餘
與女=與女
與女斗=與女鬥
與他=與他
與他一斗=與他一鬥
與她=與她
與她一斗=與她一鬥
舔干=舔乾
舞卷=舞捲
舞後=舞后
舞娘=舞孃
萝卜=蘿蔔
营干=營幹
萦回=縈迴
蒙冲=蒙衝
蒙住=矇住
蒙沖=蒙衝
蒙昧=矇昧
蒙胧=矇矓
蒙叟=矇叟
蒙眬=矇矓
蒙敝=矇蔽
蒙混=矇混
蒙骗=矇騙
蒙雾=濛霧
蒙瞀=矇瞀
蒙蒙=濛濛
蒙蒙朧=朦朦朧
蒙蒙朧朧=矇矇矓矓
蒙蒙矓=矇矇矓
蒙蔽=矇蔽
蒙瞢=矇瞢
蒙懂=懞懂
蒙瞽=矇瞽
蒙霧=濛霧
蒙騙=矇騙
蒙朧=矇矓
蒙矓=矇矓
蒲席=蒲蓆
蒸干=蒸乾
蒼郁=蒼鬱
蒼術=蒼朮
蓄发=蓄髮
蓄须=蓄鬚
蓄發=蓄髮
蓄須=蓄鬚
蓊郁=蓊鬱
蜡象=蠟像
裹扎=裹紮
裹屍=裹尸
認丑=認醜
認准=認準
誘奸=誘姦
誘欲=誘慾
誘發=誘發
誘發型=誘發型
語雲=語云
語匯=語彙
誣蔑=誣衊
誤沖=誤衝
說干=說干
說干便干=說幹便幹
說干脆=說乾脆
說干就干=說幹就幹
說不=說不
說不准=說不準
說的=說的
說的准=說的準
說得=說得
說得個准=說得個準
說簽=說籤
豪華=豪華
豪華游=豪華遊
貌丑=貌醜
賑飢=賑饑
趕制=趕製
踅門=踅門
踅門了戶=踅門瞭戶
輕台=輕颱
輕松=輕鬆
輕挑=輕佻
輕輕=輕輕
輕輕松松=輕輕鬆鬆
輕篾=輕蔑
辣面=辣麵
遞回=遞迴
遠揚=遠颺
遠游=遠遊
酸软=痠軟
酸疼=痠疼
酸軟=痠軟
酸痛=痠痛
酿制=釀製
鉸煉=鉸鍊
銀制=銀製
銀須=銀鬚
銅制=銅製
銅象=銅像
銜土=啣土
銜泥=啣泥
銜草=啣草
銜環=啣環
锻羽=鎩羽
锻炼=鍛鍊
锻链=鍛鍊
閨范=閨範
頗准=頗準
頗象=頗像
領袖=領袖
領袖欲=領袖慾
餅干=餅乾
魁悟=魁梧
魂游=魂遊
鲜于=鮮于
鳳斗=鳳鬥
鳳佔=鳳占
鳳皇=鳳皇
鳳皇於蜚=鳳皇于蜚
鳳凰=鳳凰
鳳凰於飛=鳳凰于飛
麼女=么女
麼子=么子
麼干=麼幹
麼丑=麼醜
麼弟=么弟
麼兒=么兒
麼妹=么妹
麼准=麼准
麼准的=麼準的
麼象=麼像
麼像征=麼象徵
鼻准=鼻準
鼻梁=鼻樑
齊沖=齊衝
僵尸=殭屍
僵屍=殭屍
僵蚕=殭蠶
僵绳=韁繩
僵僕=僵仆
僵繩=韁繩
僵蠶=殭蠶
儀范=儀範
億余=億餘
儆效=儆傚
儉朴=儉樸
儌幸=儌倖
凛列=凜洌
凛栗=凜慄
凜列=凜洌
凜栗=凜慄
劇斗=劇鬥
劈裡=劈里
嘩眾=嘩眾
嘩眾取寵=譁眾取寵
嘮叼=嘮叨
嘱托=囑託
嘴干=嘴乾
嘹亮=嘹喨
噓唏=歔欷
噜苏=嚕囌
噴涂=噴塗
墜胎=墮胎
增强=增強
增辟=增闢
墨沈=墨沈
墨沈未干=墨瀋未乾
嬉游=嬉遊
嬌揉=嬌揉
嬌揉造作=矯揉造作
寫字=寫字
寫字台=寫字檯
寬松=寬鬆
寬范=寬範
層理=層理
幡间=墦間
幡間=墦間
廚余=廚餘
廝斗=廝鬥
廝斗然=廝陡然
廢後=廢后
廣布=廣佈
廣征=廣徵
彈子=彈子
彈子台=彈子檯
彈涂=彈塗
彈珠=彈珠
彈珠台=彈珠檯
影後=影后
影象=影像
德国=德國
德裡=德里
慰借=慰藉
憂郁=憂鬱
憋脚=蹩腳
憋腳=蹩腳
憔瘁=憔悴
摹效=摹傚
撞球=撞球
撞球台=撞球檯
撣子=撢子
撫恤=撫卹
撫須=撫鬚
撬松=撬鬆
撲卷=撲捲
敷涂=敷塗
數天=數天
數只=數隻
數周=數週
數海=數海
數海裡=數海里
數裡=數里
暫松=暫鬆
暴冲=暴衝
暴沖=暴衝
暴卷=暴捲
暴珍=暴珍
暴珍天物=暴殄天物
標志=標誌
標注=標註
標致=標緻
標准=標準
標桿=標竿
標簽=標籤
樞鈕=樞紐
模制=模製
模范=模範
模效=模傚
樣干=樣幹
樣丑=樣醜
樣范=樣範
横冲=橫衝
横卷=橫捲
横征=橫徵
横梁=橫樑
歐游=歐遊
毆斗=毆鬥
漿劃=槳劃
潤發=潤髮
潦阔=遼闊
潦闊=遼闊
潮卷=潮捲
澆制=澆製
熨干=熨乾
熬制=熬製
獎杯=獎盃
璀灿=璀璨
璀燦=璀璨
皺折=皺摺
盤回=盤迴
盤卷=盤捲
盤涅=槃涅
盤游=盤遊
瞌然=瞌然
瞌然長逝=溘然長逝
瞎冲=瞎衝
瞎沖=瞎衝
確系=確係
確系著=確繫著
磋跎=蹉跎
稻杆=稻稈
稻谷=稻穀
稻桿=稻稈
稽征=稽徵
稽康=嵇康
箱函=箱涵
糊口=餬口
糊涂=糊塗
緝凶=緝兇
編采=編採
編發=編髮
編篡=編纂
緩沖=緩衝
緩征=緩徵
緲茫=渺茫
罷斗=罷鬥
翦彩=翦綵
膠制=膠製
蒋干=蔣幹
蓬发=蓬髮
蓬松=蓬鬆
蓬發=蓬髮
蓬蓬=蓬蓬
蓬蓬松松=蓬蓬鬆鬆
蔣干=蔣幹
蔥郁=蔥鬱
蔭郁=蔭鬱
蝨目=虱目
褐发=褐髮
褐發=褐髮
觑准=覷準
誰干=誰幹
誰干脆=誰乾脆
誰干淨=誰乾淨
誰是=誰是
誰是於=誰是于
課余=課餘
課征=課徵
調制=調製
調制解調=調制解調
調松=調鬆
調准=調準
請托=請託
諸余=諸餘
諸候=諸侯
豬只=豬隻
豬舌=豬舌
豬舌面=豬舌麵
豬肝=豬肝
豬肝面=豬肝麵
豬腳=豬腳
豬腳面=豬腳麵
賜復=賜覆
賣奸=賣姦
賣姜=賣薑
質朴=質樸
賭斗=賭鬥
賭台=賭檯
賭台灣=賭台灣
踐道=棧道
踢踏=踢踏
踢踏舞=踢躂舞
輩子=輩子
輩子干=輩子幹
輪回=輪迴
輪奸=輪姦
輪流=輪流
輪流干=輪流幹
遨游=遨遊
遮丑=遮醜
鄭凱=鄭凱
鄭凱云=鄭凱云
鄰裡=鄰里
醃制=醃製
醃臢=腌臢
醇朴=醇樸
醋坛=醋罈
醋壇=醋罈
銷溶=銷鎔
鋁制=鋁製
鋪位=舖位
閫范=閫範
震松=震鬆
震栗=震慄
震荡=震盪
震蕩=震盪
鞑伐=撻伐
頜須=頜鬚
题签=題籤
飘游=飄遊
養發=養髮
駐扎=駐紮
髯发=髯髮
髯胡=髯鬍
髯须=髯鬚
髯發=髯髮
髯須=髯鬚
鹤发=鶴髮
儒子=儒子
儒子可教=孺子可教
凝干=凝乾
勳級=勛級
勳章=勛章
勳爵=勛爵
噪动=譟動
噪诈=譟詐
噪動=譟動
噪詐=譟詐
噫籲=噫吁
墾辟=墾闢
壇女=壇女
壇女兒紅=罈女兒紅
壇子=罈子
壇白=壇白
壇白干=罈白干
壇好=壇好
壇好酒=罈好酒
壇老=壇老
壇老酒=罈老酒
壇佳=壇佳
壇佳釀=罈佳釀
壇美=壇美
壇美酒=罈美酒
壇酒=罈酒
壇高=壇高
壇高粱=罈高粱
壇陳=壇陳
壇陳年=罈陳年
壇醋=罈醋
壇壇=壇壇
壇壇罐罐=罈罈罐罐
壇燒=壇燒
壇燒刀子=罈燒刀子
壇騞=罈騞
奮斗=奮鬥
嬖幸=嬖倖
嬴余=嬴餘
導游=導遊
憑吊=憑弔
憑借=憑藉
憑准=憑準
懈松=懈鬆
懈迨=懈怠
懊郁=懊鬱
懍栗=懍慄
懔栗=懍慄
戰天=戰天
戰天斗地=戰天鬥地
戰斗=戰鬥
戰栗=顫慄
撻虜=韃虜
擋御=擋禦
擐系=擐繫
擔仔=擔仔
擔仔面=擔仔麵
擔擔=擔擔
擔擔面=擔擔麵
整出=整出
整出劇=整齣劇
整出戲=整齣戲
整只=整隻
整并=整併
整並=整併
整周=整週
整個=整個
樵采=樵採
樹干=樹幹
橋梁=橋樑
橘梗=桔梗
機抒=機杼
機器=機器
機器壓制=機器壓製
橫沖=橫衝
橫卷=橫捲
橫征=橫徵
橫梁=橫樑
歷日=曆日
歷月=曆月
歷法=曆法
歷書=曆書
歷象=曆象
歷落=曆落
歷數=曆數
激干=激幹
激斗=激鬥
激发=激發
激荡=激盪
激蕩=激盪
濃發=濃髮
濃纖=穠纖
燈彩=燈綵
燎发=燎髮
燎發=燎髮
燒干=燒乾
燒制=燒製
燒毀=燒燬
燕国=燕國
燕游=燕遊
燕燕=燕燕
燕燕於飛=燕燕于飛
燙面=燙麵
燙發=燙髮
獨斗=獨鬥
獨游=獨遊
獨辟=獨闢
獨辟蹊徑=獨闢蹊徑
獨鐘=獨鍾
瞥准=瞥準
磨制=磨製
積谷=積穀
積郁=積鬱
積淀=積澱
窺准=窺準
縈回=縈迴
縝致=縝緻
縣志=縣誌
翱游=翱遊
膨松=膨鬆
蕩口=盪口
蕩舟=盪舟
蕩秋=蕩秋
蕩秋千=盪鞦韆
蕩氣=蕩氣
蕩氣回陽=蕩氣迴陽
蕩氣回腸=蕩氣迴腸
蕩開=盪開
褴缕=襤褸
親自=親自
親自干=親自幹
諺雲=諺云
謀干=謀幹
赞同=贊同
赞成=贊成
赞礼=贊禮
赞助=贊助
赞拜=贊拜
赞理=贊理
赞善=贊善
赞普=贊普
赞翼=贊翼
輯凶=輯兇
辨奸=辨奸
辨奸論=辨姦論
選准=選準
遺范=遺範
遺象=遺像
遺跡=遺蹟
遺撼=遺憾
遼沈=遼瀋
遼亮=嘹喨
鋼制=鋼製
鋼梁=鋼樑
錄制=錄製
錄象=錄像
錄影=錄影
錄影後=錄影後
錙衣=緇衣
錢鐘=錢鐘
錢鐘書=錢鍾書
錦鏢=錦標
錫制=錫製
錫坤=錫堃
镜象=鏡像
雕虫=彫蟲
雕丧=彫喪
雕残=彫殘
雕梁=雕樑
雕喪=彫喪
雕殘=彫殘
雕谢=彫謝
雕象=雕像
雕落=彫落
雕零=彫零
雕謝=彫謝
雕蟲=彫蟲
靦典=靦腆
頭扎=頭紮
頭花=頭花
頭花發=頭花髮
頭亮=頭亮
頭亮發=頭亮髮
頭散=頭散
頭散發=頭散髮
頭發=頭髮
頭發了狂=頭發了狂
頭發了瘋=頭發了瘋
頭發力=頭發力
頭發出=頭發出
頭發功=頭發功
頭發生=頭發生
頭發光=頭發光
頭發光光=頭髮光光
頭發光束=頭髮光束
頭發光禿=頭髮光禿
頭發光芒=頭髮光芒
頭發光怪=頭髮光怪
頭發光明=頭髮光明
頭發光油=頭髮光油
頭發光采=頭髮光采
頭發光亮=頭髮光亮
頭發光朗=頭髮光朗
頭發光彩=頭髮光彩
頭發光斑=頭髮光斑
頭發光棍=頭髮光棍
頭發光華=頭髮光華
頭發光塌=頭髮光塌
頭發光溜=頭髮光溜
頭發光滑=頭髮光滑
頭發光煇=頭髮光煇
頭發光電=頭髮光電
頭發光潤=頭髮光潤
頭發光輪=頭髮光輪
頭發光撻=頭髮光撻
頭發光澤=頭髮光澤
頭發光臨=頭髮光臨
頭發光麗=頭髮光麗
頭發光耀=頭髮光耀
頭發光靈=頭髮光靈
頭發光豔=頭髮光豔
頭發呆=頭發呆
頭發狂=頭發狂
頭發育=頭發育
頭發炎=頭發炎
頭發音=頭發音
頭發售=頭發售
頭發現=頭發現
頭發麻=頭發麻
頭發黑=頭發黑
頭發瘋=頭發瘋
頭發黴=頭發霉
頰須=頰鬚
頸系=頸繫
頹圯=頹圮
颠仆=顛仆
颠复=顛覆
飙卷=飆捲
餐台=餐檯
餛飩=餛飩
餛飩面=餛飩麵
骼膊=胳膊
髭须=髭鬚
髭須=髭鬚
鲸须=鯨鬚
龍卷=龍卷
龍卷風=龍捲風
龍眼=龍眼
龍眼干=龍眼乾
龍須=龍鬚
龍鐘=龍鍾
優游=優遊
壑然=豁然
壓咸=壓鹹
壓面=壓面
壓面棍=壓麵棍
彌山=彌山
彌山遍野=瀰山遍野
彌散=瀰散
彌漫=瀰漫
彌蒙=瀰濛
彌彌=瀰瀰
徽菌=黴菌
懇托=懇託
應征=應徵
應象=應像
戲扎=戲紮
戲彩=戲綵
戴克=戴克
戴克裡先=戴克里先
戴表=戴錶
擢发=擢髮
擢足=濯足
擢發=擢髮
擦干=擦乾
擦幹=擦乾
擰干=擰乾
擰松=擰鬆
濕發=濕髮
濕發光=濕發光
濕發光巴=濕髮光巴
濕發光光=濕髮光光
濕發光束=濕髮光束
濕發光禿=濕髮光禿
濕發光芒=濕髮光芒
濕發光怪=濕髮光怪
濕發光明=濕髮光明
濕發光油=濕髮光油
濕發光波=濕髮光波
濕發光采=濕髮光采
濕發光亮=濕髮光亮
濕發光朗=濕髮光朗
濕發光彩=濕髮光彩
濕發光斑=濕髮光斑
濕發光棍=濕髮光棍
濕發光華=濕髮光華
濕發光塌=濕髮光塌
濕發光溜=濕髮光溜
濕發光滑=濕髮光滑
濕發光煇=濕髮光煇
濕發光電=濕髮光電
濕發光潤=濕髮光潤
濕發光輪=濕髮光輪
濕發光撻=濕髮光撻
濕發光澤=濕髮光澤
濕發光臨=濕髮光臨
濕發光麗=濕髮光麗
濕發光耀=濕髮光耀
濕發光靈=濕髮光靈
濕發光豔=濕髮光豔
濛松=濛鬆
濫芋=濫芋
濫芋充數=濫竽充數
濫征=濫徵
營干=營幹
燴干=燴乾
燴制=燴製
璨烂=燦爛
璨爛=燦爛
環佩=環珮
環游=環遊
瞧不=瞧不
瞧不准=瞧不準
瞧准=瞧準
瞧著=瞧著
篷松=篷鬆
篾箪=篾簟
篾簞=篾簟
糟达=蹧躂
糟塌=糟蹋
糟達=蹧躂
糟遢=糟蹋
縫扎=縫紮
縫制=縫製
縫紝=縫紉
縮栗=縮慄
縱欲=縱慾
縱橫=縱橫
縱橫交布=縱橫交佈
縻系=縻繫
總理=總理
繁复=繁複
繁復=繁複
羁拌=羈絆
聯手=聯手
聯手斗=聯手鬥
聯系=聯繫
聯系統=聯系統
聯征=聯徵
聯准=聯准
聯准局=聯準局
膺品=贗品
膽戰=膽顫
臂一=臂一
臂一卷=臂一捲
薄幸=薄倖
薦飢=薦饑
褻讀=褻瀆
襁保=襁褓
覬幸=覬倖
豁上=豁上
豁上干=豁上幹
豁出=豁出
豁出命干=豁出命幹
豁死=豁死
豁死干=豁死幹
豁命=豁命
豁命干=豁命幹
豁起=豁起
豁起來干=豁起來幹
豁壑=谿壑
賸余=賸餘
購並=購併
購並不=購並不
購並且=購並且
購並非=購並非
購買=購買
購買欲=購買慾
赢余=贏餘
趨之=趨之
趨之若務=趨之若鶩
蹉陀=蹉跎
蹒顸=顢頇
辫发=辮髮
邀天=邀天
邀天之幸=邀天之倖
邀斗=邀鬥
邂怠=懈怠
還丑=還醜
還要=還要
還要丑=還要醜
還象=還像
還象征服=還像征服
鍛羽=鎩羽
鍛煉=鍛鍊
鍛鏈=鍛鍊
雖然=雖然
雖然丑=雖然醜
韓制=韓製
騁凶=騁兇
骤松=驟鬆
鴻范=鴻範
鴻准=鴻準
點干=點幹
點干吧=點幹吧
點松=點鬆
點象=點像
嚕嚕=嚕嚕
嚕嚕蘇蘇=嚕嚕囌囌
嚕蘇=嚕囌
懰栗=懰慄
擺布=擺佈
擺蕩=擺盪
斷發=斷髮
櫃台=櫃檯
歸朴=歸璞
歸究=歸咎
歸並=歸併
歸並不=歸並不
歸並且=歸並且
歸並非=歸並非
歸依=歸依
歸依佛門=皈依佛門
歸依我佛=皈依我佛
歸真=歸真
歸真反朴=歸真反璞
歸裡=歸里
燼余=燼餘
禮贊=禮讚
簡朴=簡樸
簫條=蕭條
繞梁=繞樑
繡象=繡像
翻云=翻雲
翻台=翻檯
翻來=翻來
翻來復去=翻來覆去
翻卷=翻捲
翻松=翻鬆
翻雲復雨=翻雲覆雨
舊游=舊遊
舊歷=舊曆
舊歷史=舊歷史
蕴函=蘊涵
蕴借=蘊藉
蕴酿=醞釀
觴子=殤子
謬贊=謬讚
謷丑=謷醜
豐姿=丰姿
豐度=丰度
豐神=丰神
豐情=丰情
豐諛=豐腴
豐韻=丰韻
蹣頇=顢頇
軀干=軀幹
轉托=轉託
轉戾=轉戾
轉戾點=轉捩點
轉寰=轉圜
醬面=醬麵
鎖煉=鎖鍊
鎖碎=瑣碎
鎚煉=錘煉
鎧胄=鎧冑
闔府上下=閤府上下
闔家=閤家
雙斗=雙鬥
雙並=雙併
雙周=雙週
雜志=雜誌
雞只=雞隻
雞奸=雞姦
雞絲=雞絲
雞絲面=雞絲麵
雞腿=雞腿
雞腿面=雞腿麵
鞣制=鞣製
題簽=題籤
鬈发=鬈髮
鬈發=鬈髮
魏国=魏國
魏征=魏徵
鵝准=鵝準
壞簽=壞籤
懷表=懷錶
攏斷=壟斷
瀝干=瀝乾
爆发=爆發
獸奸=獸姦
獸欲=獸慾
疆弩=疆弩
疆弩之末=彊弩之末
穩扎=穩紮
穩且=穩且
穩且准=穩且準
穩穩=穩穩
穩穩當當=穩穩當當
簽卜=籤卜
簽文=籤文
簽爪=籤爪
簽條=籤條
簽筒=籤筒
簽詩=籤詩
繪制=繪製
羅音=囉音
羅哩=囉哩
羅唆=囉唆
羅嗦=囉嗦
羅裡=羅里
羅裡羅蘇=囉哩囉囌
羅裡囉唆=囉哩囉唆
羅裡囉嗦=囉哩囉嗦
羅羅=羅羅
羅羅蘇蘇=囉囉囌囌
羅難=罹難
羅蘇=囉囌
羅囉=囉囉
羅囉唆唆=囉囉唆唆
羅囉嗦嗦=囉囉嗦嗦
羹面=羹麵
藤条=籐條
藤制=藤製
藤條=籐條
藤椅=籐椅
藥而=藥而
藥而愈=藥而癒
藥制=藥製
藥簽=藥籤
蟹螫=蟹螯
覷准=覷準
譁的一聲=嘩的一聲
譁啦=嘩啦
譁喇=嘩喇
譁譁=嘩嘩
谶悔=懺悔
贊：=讚：
贊一=贊一
贊一句=讚一句
贊一聲=讚一聲
贊一贊=讚一讚
贊了=讚了
贊口=贊口
贊口不=讚口不
贊不=贊不
贊不絕口=讚不絕口
贊他=讚他
贊仰=讚仰
贊她=讚她
贊好=讚好
贊自=贊自
贊自己=讚自己
贊你=讚你
贊妙=讚妙
贊我=讚我
贊那=讚那
贊佩=讚佩
贊兩=贊兩
贊兩句=讚兩句
贊的=讚的
贊美=讚美
贊個=贊個
贊個不=讚個不
贊得=讚得
贊您=讚您
贊捧=讚捧
贊許=讚許
贊這=讚這
贊揚=讚揚
贊羡=讚羨
贊著=讚著
贊詞=讚詞
贊詠=讚詠
贊羨=讚羨
贊過=讚過
贊道=讚道
贊頌=讚頌
贊嘆=讚歎
贊歌=讚歌
贊誦=讚誦
贊樂=讚樂
贊賞=讚賞
贊聲=讚聲
贊辭=讚辭
贊譽=讚譽
轎夫=轎伕
辭匯=辭彙
邊斗=邊斗
邊斗邊=邊鬥邊
邋塌=邋遢
邋蹋=邋遢
醮墨=蘸墨
鏟刈=剷刈
鏟去=剷去
鏟平=剷平
鏟起=剷起
鏟除=剷除
鏟滅=剷滅
鏡象=鏡像
關系=關係
關系統=關系統
難干=難乾
難斗=難斗
難斗的=難鬥的
難舍=難捨
難咽=難嚥
願干=願幹
願干一杯=願乾一杯
願干旱=願乾旱
願干那杯=願乾那杯
願干坤=願乾坤
願干杯=願乾杯
願干脆=願乾脆
願干涸=願乾涸
願干淨=願乾淨
願干這杯=願乾這杯
願干燥=願乾燥
願干糧=願乾糧
願意=願意
願意干=願意幹
願意干坤=願意乾坤
顛復=顛覆
顛僕=顛仆
顛顛=顛顛
顛顛僕僕=顛顛仆仆
颤斗=顫抖
颤栗=顫慄
鯨須=鯨鬚
嚴複=嚴復
懸梁=懸樑
懸臂=懸臂
懸臂梁=懸臂樑
獻丑=獻醜
競斗=競鬥
籍口=藉口
繼續=繼續
繼續干=繼續幹
纂位=篡位
艦只=艦隻
艨冲=艨衝
艨沖=艨衝
蘇裡=蘇里
蘇醒=甦醒
蘊函=蘊涵
蘊借=蘊藉
蘊釀=醞釀
襤縷=襤褸
觸須=觸鬚
警剔=警惕
譯注=譯註
贏余=贏餘
躁郁=躁鬱
辮發=辮髮
鐘不=鍾不
鐘欣=鐘欣
鐘欣桐=鍾欣桐
鐘表=鐘錶
鐘表示=鍾表示
鐘表決=鍾表決
鐘表明=鍾表明
鐘表面=鐘錶面
鐘表現=鐘表現
鐘表態=鍾表態
鐘表演=鐘表演
鐘表露=鍾表露
鐘情=鍾情
鐘馗=鍾馗
鐘無=鐘無
鐘無豔=鍾無艷
鐘意=鍾意
鐘愛=鍾愛
飄游=飄遊
饋贈=餽贈
騰格=騰格
騰格裡=騰格里
騷首=騷首
騷首弄姿=搔首弄姿
鬓发=鬢髮
鬓须=鬢鬚
屬制=屬製
懼栗=懼慄
攝制=攝製
攝服=懾服
攝象=攝像
攝影=攝影
攝影後=攝影後
欄桿=欄杆
灌制=灌製
續弦=續絃
纏斗=纏鬥
纏卷=纏捲
蠟象=蠟像
護發=護髮
鐵制=鐵製
鐵煉=鐵鍊
鐵槌=鐵鎚
鐵練=鐵鍊
露丑=露醜
響當=響噹
響當當=響噹噹
顧恤=顧卹
飆卷=飆捲
鶴發=鶴髮
齧齒=囓齒
囉裡=囉里
懿范=懿範
權力=權力
權力欲=權力慾
權斗=權鬥
灘涂=灘塗
聽不=聽不
聽不准=聽不準
聽著=聽著
襲卷=襲捲
讀取=讀取
讀取頭=讀取頭
讀寫=讀寫
讀寫頭=讀寫頭
镶制=鑲製
镶崁=鑲嵌
韃伐=撻伐
顫斗=顫抖
顫栗=顫慄
髒腑=臟腑
髒器=臟器
攣生=孿生
曬干=曬乾
曬谷=曬穀
纖夫=縴夫
蘿卜=蘿蔔
蘿卜干=蘿蔔乾
變丑=變醜
變征=變徵
變松=變鬆
顯象=顯像
驚栗=驚慄
驚螫=驚蟄
驚贊=驚讚
體征=體徵
體范=體範
黴天=霉天
黴味=霉味
黴雨=霉雨
黴氣=霉氣
黴運=霉運
黴頭=霉頭
黴濕=霉濕
黴爛=霉爛
囑托=囑託
羈拌=羈絆
讖悔=懺悔
釀制=釀製
靈俐=伶俐
靈欲=靈慾
靈幡=靈旛
驟松=驟鬆
鬢發=鬢髮
鬢須=鬢鬚
鹽余=鹽餘
鹽鹵=鹽滷
籮卜=蘿蔔
蠻干=蠻幹
蠻干淨=蠻乾淨
蠻干爽=蠻乾爽
蠻干燥=蠻乾燥
蠻准=蠻準
觀斗=觀鬥
觀采=觀採
鑲制=鑲製
鑲崁=鑲嵌
鸕慈=鸕鶿
豔後=豔后
籲了=吁了
籲咈=吁咈
籲俞=吁俞
籲氣=吁氣
籲嗟=吁嗟
籲嘆=吁嘆
籲噓=吁噓
籲籲=吁吁
