八濛山=八濛山
上鍊=上链
么麼=幺麽
么麽=幺麽
千鍾粟=千锺粟
幺麼=幺麽
反反覆覆=反反复复
反覆=反复
手鍊=手链
文錦覆阱=文锦复阱
木吒=木吒
木咤=木吒
以功覆過=以功复过
出醜狼藉=出丑狼借
尼乾陀=尼乾陀
申覆=申复
示覆=示复
名覆金甌=名复金瓯
回覆=回复
老態龍鍾=老态龙锺
彷彿=仿佛
李乾德=李乾德
李澤鉅=李泽钜
李鍊福=李链福
李鍾郁=李锺郁
沈沒=沉没
沈船=沉船
沈積=沉积
沈默=沉默
見覆=见复
角徵=角徵
角徵羽=角徵羽
侔德覆載=侔德复载
函覆=函复
拉鍊=拉链
於世成=於世成
於乎=於乎
於仲完=於仲完
於竹屋=於竹屋
於邑=於邑
於其一=於其一
於呼哀哉=於呼哀哉
於坦=於坦
於忠祥=於忠祥
於則=於则
於勇明=於勇明
於倫=於伦
於崇文=於崇文
於惟一=於惟一
於敖=於敖
於梨華=於梨华
於清言=於清言
於陵子=於陵子
於單=於单
於琳=於琳
於菟=於菟
於穆=於穆
於戲=於戏
明瞭=明了
明覆=明复
狐藉虎威=狐借虎威
金吒=金吒
金咤=金吒
金鍊=金链
拜覆=拜复
流徵=流徵
牴牾=抵牾
牴觸=抵触
甚鉅=甚钜
計畫=计划
重覆=重复
凌藉=凌借
哪吒=哪吒
哪咤=哪吒
家俱=家具
射覆=射复
素藉=素借
茵藉=茵借
衹見樹木=只见树木
衹得=只得
乾元=乾元
乾旦=乾旦
乾宅=乾宅
乾卦=乾卦
乾坤=乾坤
乾紅=乾红
乾清宮=乾清宫
乾盛世=乾盛世
乾造=乾造
乾陵=乾陵
乾象=乾象
乾隆=乾隆
乾道=乾道
乾嘉=乾嘉
乾圖=乾图
乾綱=乾纲
乾縣=乾县
乾斷=乾断
乾曜=乾曜
康乾=康乾
張法乾=张法乾
情有獨鍾=情有独锺
旋乾轉坤=旋乾转坤
畢昇=毕昇
郭子乾=郭子乾
酝藉=酝借
黄鍾公=黄锺公
傢具=家具
傢俱=家具
朝乾夕惕=朝乾夕惕
發覆=发复
答覆=答复
貂覆額=貂复额
買臣覆水=买臣复水
鈕釦=纽扣
鈞覆=钧复
雁杳魚沈=雁杳鱼沉
項鍊=项链
傷亡枕藉=伤亡枕借
滑藉=滑借
禀覆=禀复
萬鍾=万锺
鉅子=钜子
鉅防=钜防
鉅萬=钜万
電覆=电复
蒜薹=蒜薹
踅門瞭戶=踅门了户
鉸鍊=铰链
銀鍊=银链
頗覆=颇复
麼些族=麽些族
徵弦=徵弦
徵音=徵音
徵絃=徵弦
徵調=徵调
徵聲=徵声
樊於期=樊於期
憑藉=凭借
篤麼=笃麽
蕓薹=芸薹
蕩覆=荡复
蕭乾=萧乾
錢鍾書=钱锺书
頸鍊=颈链
瞭如=了如
瞭若指掌=了若指掌
瞭然=了然
瞭解=了解
鍊子=链子
鍊形=链形
鍊條=链条
鍊墜=链坠
鍊錘=链锤
鍊鎖=链锁
鍛鍾=锻锺
鍾重發=锺重发
鍾馗=锺馗
鍾萬梅=锺万梅
鍾鍛=锺锻
藉口=借口
藉手=借手
藉方=借方
藉代=借代
藉以=借以
藉卉=借卉
藉由=借由
藉此=借此
藉助=借助
藉故=借故
藉甚=借甚
藉草枕塊=借草枕块
藉寇兵=借寇兵
藉條=借条
藉喻=借喻
藉著=借着
藉詞=借词
藉資=借资
藉槁=借槁
藉端=借端
藉箸代籌=借箸代筹
藉據=借据
藉機=借机
藉藉=借借
藉藉无名=藉藉无名
藉讀=借读
覆上=复上
覆文=复文
覆成=复成
覆住=复住
覆呈=复呈
覆育=复育
覆命=复命
覆宗=复宗
覆杯=复杯
覆盂=复盂
覆信=复信
覆冒=复冒
覆按=复按
覆校=复校
覆逆=复逆
覆帳=复帐
覆鹿尋蕉=复鹿寻蕉
覆鹿遺蕉=复鹿遗蕉
覆瓿=复瓿
覆電=复电
覆鼎=复鼎
覆墓=复墓
覆蕉尋鹿=复蕉寻鹿
覆幬=复帱
覆醢=复醢
覆醬瓿=复酱瓿
覆露=复露
鎖鍊=锁链
顛乾倒坤=颠乾倒坤
籌畫=筹划
鐵鍊=铁链
露覆=露复
顧藉=顾借
變徵=变徵
躪藉=躏借
