;=====================================
;格式1：繁體中文=簡體中文
;格式2：繁體中文=簡體中文=英文
;範例1：專案=項目=project
;範例2：專案=項目
;分號後面的文字都會被忽略（不處理）。
;=====================================
相依性注入=依赖注入=dependency injection
擴充方法=扩展方法;extension method
可擴充性=可扩展性;extensibility
預設=默认;default
內建=自带;built-in
建構函式=构造函数;constructor
建構式注入=构造函数注入
建構式=构造函数
類別名稱=类名;class name
類別庫=类库;class library
類別=类型;class
物件導向=面向对象;object oriented
物件=对象;object
批次=批量;batch
原始程式碼=源代码;source code
原始碼=源代码;source code
程式碼=代码;code
快取=缓存;cache
委派=委托;delegate
除錯=调试;debug
偵錯=调试;debug
註解=注释;comment
;=======================
組態檔=配置文件
組態=配置
透過=通过
相依關係=依赖关系
相依性=依赖性
相依類型=依赖类型
軟體開發實務=软件开发实践
呼叫端=调用端
呼叫=调用
修正臭蟲=修复 bug
針對介面寫程式=针对接口编程
介面=接口;interface
登入=登录
雙因素驗證=两步骤验证
相依反轉原則=依赖倒置原则
訊息推播=信息推送
;========================
擴充機制=扩展机制
展現層=表示层
商業邏輯層=业务逻辑层
商業邏輯=业务逻辑
資料存取層=数据访问层
資料傳送物件=数据传输对象;DTO
檢視模型=视图模型;view model
組件參考=组件引用
專案參考=項目引用;project reference (Visual Studio)
物件關聯對應=对象关系映射
桌上型=桌面
;========================
分散式交易=分布式事務;distributed transaction
列舉=枚舉;enumeration
堆積=堆;heap
呼叫函式=调用函数;calling a function
呼叫方法=調用方法;calling a function
實作=实现;implementation
實體化=实例化;instanciate
迴圈=循环;loop
多載=重载;overload
效能=性能;performance
平行運算=并行计算;parallelism
傳回=返回;return
回傳=返回;return
強型別=强类型;strong type
型別=类型;type
實質型別=值类型;value type
變數=变量;variable
交易=事务;transaction
繫結=绑定;binding
選單=菜单;menu
專案=项目;project
巡覽=导航;navigate
啟動=激活=activate
轉接器=适配器;adatper
網址列=地址欄;address bar
雲端運算=云计算;cloud computing
文件=文檔;document
整合=集成;integrate
埠=端口;port
伺服器端=服务器端;server side
示範=演示;demostration
二分搜尋=二分查找;binary search
二元樹=二叉数;binary tree
交易=事務;transaction
資料存取=数据访问;data access
巢狀查詢=嵌套查询;nested query
觸發程序=触发器;trigger
行動裝置=移动设备